[layer]
type=Tile Layer 1
data=
0,0,1,1,0,21,0,1,1,0,0,
0,17,1,1,1,21,17,1,1,1,0,
0,1,0,0,1,21,1,0,0,1,0,
0,1,0,1,1,21,1,0,1,1,0,
0,1,0,0,1,21,1,0,0,1,0,
0,1,0,1,1,21,1,24,1,1,0,
0,1,0,0,16,21,1,0,24,1,0,
0,1,0,0,1,21,1,0,0,1,0,
0,0,1,1,0,21,0,1,1,0,0,
0,0,0,0,0,0,0,0,0,0,0,
0,0,0,0,0,0,0,0,0,0,0,
0,0,0,0,0,0,0,0,0,0,0,
0,0,0,0,0,0,0,0,0,0,0.
[layer]
type=Tile Layer 2
data=
0,0,57,57,0,0,0,57,57,0,0,
0,25,50,50,50,0,25,50,50,50,0,
0,49,0,0,49,0,49,0,0,49,0,
0,48,0,48,48,0,48,0,48,48,0,
0,47,0,0,47,0,47,0,0,47,0,
0,69,0,69,69,0,69,0,69,69,0,
0,69,0,0,34,0,69,0,0,69,0,
0,45,0,0,45,0,45,0,0,45,0,
0,0,44,44,0,0,0,44,44,0,0,
0,0,0,0,0,0,0,0,0,0,0,
0,0,0,0,0,0,0,0,0,0,0,
0,0,0,0,0,0,0,0,0,0,0,
0,0,0,0,0,0,0,0,0,0,0.