[layer]
type=Tile Layer 1
data=
1,21,1,16,16,0,1,0,1,0,0,
21,0,1,1,1,0,1,7,17,0,0,
16,8,16,1,1,21,1,8,1,1,1,
0,0,1,1,1,21,1,0,0,24,0,
1,1,1,1,1,0,1,1,1,0,1,
1,0,0,21,1,7,1,1,17,24,1,
1,0,0,0,1,0,1,1,1,21,1,
0,0,21,0,1,0,1,1,1,0,0,
1,0,1,1,1,1,1,1,1,1,1,
1,1,1,1,0,1,1,1,1,1,1,
1,1,1,0,1,1,16,1,16,1,1,
21,8,0,0,1,1,1,1,1,1,1,
0,21,0,0,1,1,1,1,1,0,0,
21,0,0,0,1,1,1,1,1,1,1,
21,0,0,0,1,1,1,1,1,0,0,
1,1,1,1,1,1,1,1,1,21,7,
1,1,1,0,0,0,1,0,0,21,0,
0,0,0,0,0,0,0,0,0,0,0,
0,0,0,0,0,0,0,0,0,0,0,
0,0,0,0,0,0,0,0,0,0,0,
0,0,0,0,0,0,0,0,0,0,0.
[layer]
type=Tile Layer 2
data=
72,0,72,36,36,0,72,0,72,0,0,
0,0,115,115,115,0,115,0,57,0,0,
76,0,76,152,152,0,152,0,152,152,152,
0,0,112,112,112,0,112,0,0,0,0,
61,61,61,61,61,0,61,61,61,0,61,
134,0,0,0,134,0,134,134,67,0,134,
66,0,0,0,66,0,66,66,66,0,66,
0,0,0,0,60,0,60,60,60,0,0,
47,0,47,47,47,47,47,47,47,47,47,
47,47,47,47,0,47,47,47,47,47,47,
42,42,42,0,42,42,21,42,21,42,42,
0,0,0,0,79,79,79,79,79,79,79,
0,0,0,0,52,52,52,52,52,0,0,
0,0,0,0,51,51,51,51,51,51,51,
0,0,0,0,50,50,50,50,50,0,0,
66,66,66,66,66,66,66,66,66,0,0,
48,48,48,0,0,0,48,0,0,0,0,
0,0,0,0,0,0,0,0,0,0,0,
0,0,0,0,0,0,0,0,0,0,0,
0,0,0,0,0,0,0,0,0,0,0,
0,0,0,0,0,0,0,0,0,0,0.