[layer]
type=Tile Layer 1
data=
1,1,0,3,1,1,5,1,0,0,1,
3,1,0,1,9,1,5,1,0,1,1,
1,1,0,1,1,1,1,1,0,0,0,
1,1,0,1,9,1,1,1,1,1,0,
1,1,0,5,1,5,0,0,0,1,0,
0,1,3,0,0,0,0,0,5,1,0,
0,1,1,1,1,1,0,0,1,1,0,
0,1,9,1,1,1,1,0,1,1,0,
0,1,1,1,0,0,0,0,0,0,0,
0,0,0,0,0,0,0,0,0,0,0,
0,0,0,0,0,0,0,0,0,0,0.
[layer]
type=Tile Layer 2
data=
37,37,0,37,27,27,27,37,0,0,54,
33,33,0,33,24,24,24,33,0,33,33,
37,37,0,37,27,27,27,37,0,0,0,
33,33,0,33,24,24,24,24,24,33,0,
33,42,0,42,30,42,0,0,0,60,0,
0,42,42,0,0,0,0,0,42,42,0,
0,42,30,30,30,42,0,0,42,42,0,
0,60,60,60,60,80,60,0,60,60,0,
0,33,30,42,0,0,0,0,0,0,0,
0,0,0,0,0,0,0,0,0,0,0,
0,0,0,0,0,0,0,0,0,0,0.