[layer]
type=Tile Layer 1
data=
7,1,1,1,1,1,1,1,1,1,7,
1,0,1,1,1,7,1,1,1,0,1,
1,0,1,1,1,7,1,1,1,0,1,
1,1,1,1,7,0,7,1,1,1,1,
1,0,1,7,1,0,1,7,1,0,1,
1,0,7,1,1,0,1,1,7,0,1,
1,1,1,1,1,0,1,1,1,1,1,
0,0,0,0,0,0,0,0,0,0,0,
0,0,0,0,0,0,0,0,0,0,0,
0,0,0,0,0,0,0,0,0,0,0,
0,0,0,0,0,0,0,0,0,0,0,
0,0,0,0,0,0,0,0,0,0,0.
[layer]
type=Tile Layer 2
data=
0,50,50,50,50,50,50,50,50,50,0,
50,0,5,5,5,0,5,5,5,0,50,
50,0,40,40,40,0,40,40,40,0,50,
50,50,20,20,0,0,0,20,20,50,50,
50,0,20,0,30,0,30,0,20,0,50,
50,0,0,30,30,0,30,30,0,0,50,
30,30,30,30,30,0,30,30,30,30,30,
0,0,0,0,0,0,0,0,0,0,0,
0,0,0,0,0,0,0,0,0,0,0,
0,0,0,0,0,0,0,0,0,0,0,
0,0,0,0,0,0,0,0,0,0,0,
0,0,0,0,0,0,0,0,0,0,0.
