[layer]
type=Tile Layer 1
data=
7,1,1,1,1,1,1,1,1,1,7,
0,1,21,0,0,0,0,0,21,1,0,
0,1,21,0,1,1,1,0,21,1,0,
7,1,21,1,1,1,1,1,21,1,0,
0,1,21,0,1,1,1,0,21,1,0,
0,1,21,0,0,0,0,0,21,1,0,
0,1,1,1,1,1,1,1,1,1,0,
0,0,0,0,0,0,0,0,0,0,0,
0,1,1,1,1,1,1,1,1,1,7,
0,0,0,0,0,0,0,0,0,0,0,
0,0,0,0,0,0,0,0,0,0,0,
0,0,0,0,0,0,0,0,0,0,0,
0,0,0,0,0,0,0,0,0,0,0.
[layer]
type=Tile Layer 2
data=
0,100,100,100,100,100,100,100,100,100,0,
0,62,0,0,0,0,0,0,0,62,0,
0,54,0,0,54,54,54,0,0,54,0,
0,78,0,78,78,78,78,78,0,78,0,
0,50,0,0,50,50,50,0,0,50,0,
0,48,0,0,0,0,0,0,0,48,0,
0,38,38,38,38,38,38,38,38,38,0,
0,0,0,0,0,0,0,0,0,0,0,
0,57,57,57,57,57,57,57,57,57,0,
0,0,0,0,0,0,0,0,0,0,0,
0,0,0,0,0,0,0,0,0,0,0,
0,0,0,0,0,0,0,0,0,0,0,
0,0,0,0,0,0,0,0,0,0,0.