[layer]
type=Tile Layer 1
data=
3,3,1,1,0,0,21,0,0,0,1,
0,0,1,1,4,0,21,0,0,0,1,
0,0,0,1,6,0,0,0,0,21,0,
0,0,0,1,3,21,0,0,0,0,1,
1,1,1,1,0,1,1,3,5,3,1,
4,1,0,0,0,0,0,21,0,1,1,
1,1,1,6,0,0,21,0,0,0,0,
1,1,1,4,1,1,1,0,1,6,1,
0,1,1,6,1,1,6,0,0,21,0,
3,1,1,0,0,4,1,0,0,21,0,
0,4,0,6,1,1,1,0,0,0,1,
0,6,1,0,1,6,0,1,1,21,1,
1,1,1,0,1,0,3,4,21,1,1,
0,0,1,3,1,6,0,0,21,0,1,
0,0,1,1,0,5,0,0,0,21,1,
0,0,0,0,0,0,0,0,0,0,0,
0,0,0,0,0,0,0,0,0,0,0,
0,0,0,0,0,0,0,0,0,0,0,
0,0,0,0,0,0,0,0,0,0,0.
[layer]
type=Tile Layer 2
data=
77,77,77,77,0,0,0,0,0,0,77,
0,0,76,76,76,0,0,0,0,0,76,
0,0,0,69,69,0,0,0,0,0,0,
0,0,0,67,67,0,0,0,0,0,67,
47,47,47,47,0,47,47,47,47,47,47,
61,61,0,0,0,0,0,0,0,61,61,
60,60,60,60,0,0,0,0,0,0,0,
42,42,42,42,42,42,42,0,42,42,42,
0,53,53,53,53,53,53,0,0,0,0,
52,52,52,0,0,52,52,0,0,0,0,
0,51,0,51,51,51,51,0,0,0,51,
0,51,51,0,51,51,0,51,51,0,51,
45,45,45,0,45,0,45,45,0,45,45,
0,0,49,49,49,49,0,0,0,0,49,
0,0,48,48,0,48,0,0,0,0,48,
0,0,0,0,0,0,0,0,0,0,0,
0,0,0,0,0,0,0,0,0,0,0,
0,0,0,0,0,0,0,0,0,0,0,
0,0,0,0,0,0,0,0,0,0,0.