[layer]
type=Tile Layer 1
data=
21,0,0,0,0,0,1,1,6,1,0,
0,21,0,0,0,0,1,5,1,3,1,
21,1,4,5,6,0,1,1,1,1,1,
5,1,1,5,5,21,1,1,1,1,0,
1,6,1,3,1,0,0,21,0,0,0,
0,1,1,3,1,0,0,21,0,0,0,
0,21,0,0,0,0,1,1,1,4,0,
0,21,0,0,0,0,1,3,1,4,1,
0,4,1,1,5,21,1,1,1,3,1,
1,1,5,5,1,0,1,1,3,1,21,
3,1,1,1,5,0,0,21,0,0,0,
21,1,1,1,6,0,0,0,0,0,0,
0,0,0,0,21,0,5,1,1,1,0,
0,0,21,0,0,0,1,1,5,5,1,
0,3,1,1,1,21,6,1,6,1,1,
4,5,1,4,1,21,1,1,1,1,0,
6,1,1,1,6,0,0,21,0,0,0,
0,0,0,0,0,0,0,21,0,0,0,
0,0,0,0,0,0,0,0,0,0,0,
0,0,0,0,0,0,0,0,0,0,0,
0,0,0,0,0,0,0,0,0,0,0.
[layer]
type=Tile Layer 2
data=
0,0,0,0,0,0,77,77,77,77,0,
0,0,0,0,0,0,83,83,83,83,83,
0,73,73,73,73,0,73,73,73,73,73,
72,72,72,72,72,0,72,72,72,72,0,
73,73,73,73,73,0,0,0,0,0,0,
0,72,72,72,72,0,0,0,0,0,0,
0,0,0,0,0,0,71,71,71,71,0,
0,0,0,0,0,0,64,64,64,64,64,
0,57,57,57,57,0,57,57,57,57,57,
56,56,56,56,56,0,56,56,56,56,0,
55,55,55,55,55,0,0,0,0,0,0,
0,54,54,54,54,0,0,0,0,0,0,
0,0,0,0,0,0,53,53,53,53,0,
0,0,0,0,0,0,52,52,52,52,52,
0,46,46,46,46,0,46,46,46,46,46,
45,45,45,45,45,0,45,45,45,45,0,
49,49,49,49,49,0,0,0,0,0,0,
0,0,0,0,0,0,0,0,0,0,0,
0,0,0,0,0,0,0,0,0,0,0,
0,0,0,0,0,0,0,0,0,0,0,
0,0,0,0,0,0,0,0,0,0,0.