[layer]
type=Tile Layer 1
data=
0,0,0,0,1,1,1,1,1,0,0,
0,0,0,1,1,1,1,1,1,1,0,
0,0,1,1,1,1,1,1,1,1,0,
0,0,1,1,1,1,1,1,21,1,0,
0,0,1,1,1,1,1,21,21,1,0,
0,0,1,1,1,1,21,21,21,1,0,
0,0,1,1,1,21,21,1,1,0,0,
1,1,1,1,1,1,1,0,0,0,0,
1,1,1,1,0,0,0,0,0,0,0,
0,0,0,0,0,0,0,0,0,0,0,
0,0,0,0,0,0,0,0,0,0,0,
0,0,0,0,0,0,0,0,0,0,0,
0,0,0,0,0,0,0,0,0,0,0.
[layer]
type=Tile Layer 2
data=
0,0,0,0,83,83,83,83,83,0,0,
0,0,0,83,83,83,83,83,83,83,0,
0,0,75,75,75,75,75,75,75,75,0,
0,0,75,75,75,75,75,75,0,75,0,
0,0,74,74,74,74,74,0,0,74,0,
0,0,72,72,72,72,0,0,0,72,0,
0,0,69,69,69,0,0,69,69,0,0,
68,68,68,68,68,68,68,0,0,0,0,
68,68,68,68,0,0,0,0,0,0,0,
0,0,0,0,0,0,0,0,0,0,0,
0,0,0,0,0,0,0,0,0,0,0,
0,0,0,0,0,0,0,0,0,0,0,
0,0,0,0,0,0,0,0,0,0,0.