[layer]
type=Tile Layer 1
data=
1,1,1,16,1,16,0,1,1,1,1,
1,21,1,1,1,7,1,1,1,0,1,
1,0,1,0,0,0,21,0,1,24,1,
1,0,1,1,1,1,1,21,1,1,1,
1,0,1,16,16,1,1,0,0,21,1,
1,0,1,1,1,0,1,0,0,21,0,
16,21,16,1,1,0,1,0,0,0,0,
1,1,1,1,1,0,0,0,0,0,21,
1,0,1,1,1,21,0,0,0,0,0,
1,0,0,21,7,0,1,1,1,1,1,
1,0,7,0,0,0,1,1,1,1,1,
1,0,0,0,21,0,1,1,1,1,1,
1,0,0,21,0,0,1,1,1,1,1,
0,0,0,0,0,0,0,0,0,0,0,
0,0,0,0,0,0,0,0,0,0,0,
0,0,0,0,0,0,0,0,0,0,0,
0,0,0,0,0,0,0,0,0,0,0.
[layer]
type=Tile Layer 2
data=
48,48,48,24,48,24,0,48,48,48,48,
91,0,91,91,91,0,91,91,91,0,91,
102,0,102,0,0,0,0,0,102,0,102,
49,0,49,49,49,49,49,0,49,49,49,
60,0,60,30,30,60,60,0,0,0,60,
59,0,59,59,59,0,59,0,0,0,0,
26,0,26,52,52,0,52,0,0,0,0,
51,51,51,51,51,0,0,0,0,0,0,
50,0,50,50,50,0,0,0,0,0,0,
73,0,0,0,0,0,73,73,73,73,73,
72,0,0,0,0,0,72,72,72,72,72,
48,0,0,0,0,0,48,48,48,48,48,
47,0,0,0,0,0,47,47,47,47,47,
0,0,0,0,0,0,0,0,0,0,0,
0,0,0,0,0,0,0,0,0,0,0,
0,0,0,0,0,0,0,0,0,0,0,
0,0,0,0,0,0,0,0,0,0,0.