[layer]
type=Tile Layer 1
data=
1,4,1,21,1,4,3,0,1,1,1,
0,21,0,0,1,1,1,0,4,0,0,
6,1,1,21,1,4,1,0,1,0,1,
1,1,1,21,3,0,0,0,6,0,1,
1,1,1,1,3,1,4,4,1,0,1,
0,0,0,0,0,21,5,5,1,1,1,
1,1,1,1,1,1,1,4,0,5,1,
21,0,0,0,0,0,1,3,1,0,1,
0,0,21,0,0,0,3,1,1,0,1,
5,1,3,6,1,21,1,1,1,0,1,
1,1,3,21,5,0,0,0,0,0,1,
0,0,0,0,0,0,0,0,0,0,0,
0,0,0,0,0,0,0,0,0,0,0,
0,0,0,0,0,0,0,0,0,0,0,
0,0,0,0,0,0,0,0,0,0,0.
[layer]
type=Tile Layer 2
data=
49,49,49,0,49,49,49,0,49,49,49,
0,0,0,0,56,56,56,0,56,0,0,
49,49,49,0,49,49,49,0,49,0,49,
54,54,54,0,54,0,0,0,54,0,54,
33,33,33,33,33,33,33,33,33,0,33,
0,0,0,0,0,0,47,47,47,47,47,
32,32,32,32,32,32,32,32,0,32,32,
0,0,0,0,0,0,46,46,46,0,46,
0,0,0,0,0,0,46,46,46,0,46,
36,36,36,36,36,0,36,36,36,0,36,
44,44,44,0,44,0,0,0,0,0,44,
0,0,0,0,0,0,0,0,0,0,0,
0,0,0,0,0,0,0,0,0,0,0,
0,0,0,0,0,0,0,0,0,0,0,
0,0,0,0,0,0,0,0,0,0,0.