[layer]
type=Tile Layer 1
data=
0,2,2,2,9,2,9,2,2,2,21,
0,1,1,1,9,21,9,1,1,1,0,
0,2,2,2,9,2,9,2,2,8,0,
0,11,11,11,9,2,9,11,11,11,0,
0,0,0,0,11,11,11,0,21,0,0,
0,0,0,0,0,0,0,0,0,0,0,
21,20,20,20,9,20,9,20,20,20,0,
0,0,0,0,11,11,11,0,0,0,0,
0,0,0,0,0,0,0,0,0,0,0,
0,0,0,0,0,0,0,0,0,0,0,
0,0,0,0,0,0,0,0,0,0,0.
[layer]
type=Tile Layer 2
data=
0,27,27,27,27,27,27,27,27,27,0,
0,29,29,29,29,0,29,29,29,29,0,
0,42,42,42,28,42,28,42,42,0,0,
0,26,26,26,26,26,26,26,26,26,0,
0,0,0,0,32,32,32,0,0,0,0,
0,0,0,0,0,0,0,0,0,0,0,
0,0,0,0,25,0,25,0,0,0,0,
0,0,0,0,31,31,31,0,0,0,0,
0,0,0,0,0,0,0,0,0,0,0,
0,0,0,0,0,0,0,0,0,0,0,
0,0,0,0,0,0,0,0,0,0,0.