[layer]
type=Tile Layer 1
data=
1,1,1,1,21,21,21,1,1,1,1,
0,1,1,1,1,1,1,1,1,1,1,
0,0,1,0,1,21,1,0,1,0,0,
0,0,1,1,1,1,1,1,1,0,0,
0,0,5,0,1,1,1,0,6,0,0,
0,0,0,1,21,21,21,1,0,0,0,
0,0,0,1,1,21,1,1,0,0,0,
0,0,0,1,1,1,1,1,0,0,0,
0,0,0,0,0,0,0,0,0,0,0,
0,0,0,0,0,0,0,0,0,0,0,
0,0,0,0,0,0,0,0,0,0,0,
0,0,0,0,0,0,0,0,0,0,0,
0,0,0,0,0,0,0,0,0,0,0.
[layer]
type=Tile Layer 2
data=
47,47,47,47,0,0,0,47,47,47,47,
0,35,35,35,35,35,35,35,35,35,35,
0,0,45,0,45,0,45,0,45,0,0,
0,0,44,44,44,44,44,44,44,0,0,
0,0,44,0,44,44,44,0,44,0,0,
0,0,0,44,0,0,0,44,0,0,0,
0,0,0,41,41,0,41,41,0,0,0,
0,0,0,41,41,41,41,41,0,0,0,
0,0,0,0,0,0,0,0,0,0,0,
0,0,0,0,0,0,0,0,0,0,0,
0,0,0,0,0,0,0,0,0,0,0,
0,0,0,0,0,0,0,0,0,0,0,
0,0,0,0,0,0,0,0,0,0,0.