[layer]
type=Tile Layer 1
data=
0,1,0,0,0,0,2,8,0,4,0,
1,0,0,0,1,0,0,0,6,0,1,
0,0,0,0,1,0,0,0,0,3,0,
0,0,1,1,2,1,4,5,1,0,0,
0,2,1,5,4,1,1,5,1,2,0,
0,5,0,22,0,0,0,22,0,1,0,
0,1,0,1,0,0,0,1,0,6,0,
0,6,23,0,1,1,5,0,23,1,0,
0,5,1,1,1,4,1,1,1,6,0,
0,0,0,0,0,0,0,0,0,0,0,
0,0,0,0,0,0,0,0,0,0,0,
0,0,0,0,0,0,0,0,0,0,0,
0,0,0,0,0,0,0,0,0,0,0.
[layer]
type=Tile Layer 2
data=
0,102,0,0,0,0,102,0,0,102,0,
68,0,0,0,68,0,0,0,68,0,68,
0,0,0,0,61,0,0,0,0,61,0,
0,0,61,61,61,61,61,61,61,0,0,
0,55,55,55,55,55,55,55,55,55,0,
0,61,0,0,0,0,0,0,0,61,0,
0,59,0,59,0,0,0,59,0,59,0,
0,59,0,0,59,59,59,0,0,59,0,
0,52,52,52,52,52,52,52,52,52,0,
0,0,0,0,0,0,0,0,0,0,0,
0,0,0,0,0,0,0,0,0,0,0,
0,0,0,0,0,0,0,0,0,0,0,
0,0,0,0,0,0,0,0,0,0,0.