[layer]
type=Tile Layer 1
data=
1,1,1,1,0,1,1,1,1,1,1,
1,1,0,0,0,1,1,1,1,0,21,
1,1,24,21,0,1,1,1,1,1,0,
1,1,0,0,7,1,1,1,1,1,21,
1,1,0,0,1,1,1,1,0,0,21,
1,1,1,0,0,1,1,1,0,0,0,
1,1,1,1,0,1,0,0,21,0,0,
1,1,0,21,0,1,0,7,1,1,1,
1,1,0,0,0,1,1,0,0,0,1,
1,1,1,0,0,1,1,1,1,21,0,
1,1,1,0,1,1,1,1,1,1,1,
1,1,1,0,0,1,1,1,0,21,1,
1,1,1,21,0,1,1,1,1,0,0,
0,0,0,0,0,0,0,0,0,0,0,
0,0,0,0,0,0,0,0,0,0,0,
0,0,0,0,0,0,0,0,0,0,0,
0,0,0,0,0,0,0,0,0,0,0.
[layer]
type=Tile Layer 2
data=
47,47,47,47,0,47,47,47,47,47,47,
66,66,0,0,0,66,66,66,66,0,0,
97,97,0,0,0,97,97,97,97,97,0,
88,88,0,0,0,88,88,88,88,88,0,
58,58,0,0,58,58,58,58,0,0,0,
57,57,57,0,0,57,57,57,0,0,0,
51,51,51,51,0,51,0,0,0,0,0,
75,75,0,0,0,75,0,0,75,75,75,
49,49,0,0,0,49,49,0,0,0,49,
49,49,49,0,0,49,49,49,49,0,0,
34,34,34,0,34,34,34,34,34,34,34,
48,48,48,0,0,48,48,48,0,0,48,
47,47,47,0,0,47,47,47,47,0,0,
0,0,0,0,0,0,0,0,0,0,0,
0,0,0,0,0,0,0,0,0,0,0,
0,0,0,0,0,0,0,0,0,0,0,
0,0,0,0,0,0,0,0,0,0,0.