[layer]
type=Tile Layer 1
data=
1,1,1,1,1,21,1,1,1,1,1,
1,1,1,1,21,21,21,1,1,1,1,
1,1,1,21,21,21,21,21,1,1,1,
1,1,12,21,21,21,21,21,13,1,1,
1,1,24,1,1,1,1,1,24,1,1,
0,0,0,0,0,0,0,0,0,0,0,
0,0,0,0,0,0,0,0,0,0,0,
0,0,0,0,0,0,0,0,0,0,0,
0,0,0,0,0,0,0,0,0,0,0,
0,0,0,0,0,0,0,0,0,0,0,
0,0,0,0,0,0,0,0,0,0,0.
[layer]
type=Tile Layer 2
data=
20,30,30,30,30,0,30,30,30,30,20,
20,20,20,20,0,0,0,20,20,20,20,
20,20,20,0,0,0,0,0,20,20,20,
20,20,1,0,0,0,0,0,1,20,20,
50,50,0,50,50,50,50,50,0,50,50,
0,0,0,0,0,0,0,0,0,0,0,
0,0,0,0,0,0,0,0,0,0,0,
0,0,0,0,0,0,0,0,0,0,0,
0,0,0,0,0,0,0,0,0,0,0,
0,0,0,0,0,0,0,0,0,0,0,
0,0,0,0,0,0,0,0,0,0,0.
