[layer]
type=Tile Layer 1
data=
0,0,0,0,1,1,1,0,0,0,0,
0,0,7,1,0,0,0,1,0,0,0,
0,8,0,1,0,0,16,1,0,0,0,
0,21,0,1,1,17,1,1,0,21,0,
21,1,7,1,1,1,1,1,0,1,21,
21,1,1,0,8,0,0,0,1,1,21,
21,1,1,1,1,1,1,1,1,1,21,
0,21,1,1,1,17,1,1,1,21,0,
0,0,0,0,1,1,1,0,0,0,0,
0,0,0,0,0,0,0,0,0,0,0,
0,0,0,0,0,0,0,0,0,0,0,
0,0,0,0,0,0,0,0,0,0,0,
0,0,0,0,0,0,0,0,0,0,0.
[layer]
type=Tile Layer 2
data=
0,0,0,0,73,73,73,0,0,0,0,
0,0,0,109,0,0,0,109,0,0,0,
0,0,0,99,0,0,49,99,0,0,0,
0,0,0,66,66,33,66,66,0,0,0,
0,96,0,96,96,96,96,96,0,96,0,
0,93,93,0,0,0,0,0,93,93,0,
0,54,54,54,54,54,54,54,54,54,0,
0,0,58,58,58,29,58,58,58,0,0,
0,0,0,0,57,57,57,0,0,0,0,
0,0,0,0,0,0,0,0,0,0,0,
0,0,0,0,0,0,0,0,0,0,0,
0,0,0,0,0,0,0,0,0,0,0,
0,0,0,0,0,0,0,0,0,0,0.