[layer]
type=Tile Layer 1
data=
1,0,5,1,3,5,1,1,1,1,1,
2,0,0,0,7,0,21,0,1,5,1,
1,0,1,5,6,24,0,21,1,1,1,
1,1,1,2,1,2,1,3,0,1,1,
1,1,6,0,0,0,0,21,1,3,1,
1,1,0,1,1,1,1,1,4,3,1,
0,21,1,0,0,0,0,0,1,6,1,
4,24,1,1,1,0,0,21,1,5,1,
3,0,2,2,4,0,0,21,1,0,1,
6,0,1,2,6,0,1,2,1,21,1,
1,0,5,0,21,0,1,6,1,0,0,
4,1,6,7,24,21,1,1,1,0,1,
0,0,0,0,0,0,1,6,1,0,1,
4,2,2,0,21,7,1,1,1,0,1,
1,0,1,2,2,5,1,21,3,3,1,
1,0,5,0,4,1,1,0,0,21,0,
6,21,1,7,1,1,6,1,1,5,1,
4,8,5,0,1,0,0,0,0,21,1,
5,1,1,0,1,1,6,3,1,21,1,
0,0,0,0,0,0,0,0,0,0,0,
0,0,0,0,0,0,0,0,0,0,0,
0,0,0,0,0,0,0,0,0,0,0,
0,0,0,0,0,0,0,0,0,0,0.
[layer]
type=Tile Layer 2
data=
61,0,61,61,61,61,61,61,61,61,61,
129,0,0,0,0,0,0,0,129,129,129,
127,0,127,127,127,0,0,0,127,127,127,
65,65,65,65,65,65,65,65,0,65,65,
91,91,91,0,0,0,0,0,91,91,91,
64,64,0,64,64,64,64,64,64,64,64,
0,0,83,0,0,0,0,0,83,83,83,
123,0,123,123,123,0,0,0,123,123,123,
81,0,81,81,81,0,0,0,81,0,81,
66,0,66,66,66,0,66,66,66,0,66,
72,0,72,0,0,0,72,72,72,0,0,
142,142,142,0,0,0,142,142,142,0,142,
0,0,0,0,0,0,63,63,63,0,63,
94,94,94,0,0,0,94,94,94,0,94,
50,0,50,50,50,50,50,0,50,50,50,
61,0,61,0,61,61,61,0,0,0,0,
73,0,73,0,73,73,73,73,73,73,73,
88,0,88,0,88,0,0,0,0,0,88,
47,47,47,0,47,47,47,47,47,0,47,
0,0,0,0,0,0,0,0,0,0,0,
0,0,0,0,0,0,0,0,0,0,0,
0,0,0,0,0,0,0,0,0,0,0,
0,0,0,0,0,0,0,0,0,0,0.