[layer]
type=Tile Layer 1
data=
1,1,1,1,0,0,0,0,1,0,1,
1,9,1,0,0,1,1,0,1,0,1,
1,1,1,0,1,1,1,1,1,1,1,
1,1,1,0,0,1,1,1,1,9,1,
1,0,0,0,0,1,1,1,1,1,1,
1,0,1,1,0,0,0,0,0,1,1,
1,0,1,9,1,1,1,0,0,0,1,
1,0,1,1,1,1,1,1,1,0,0,
1,0,0,0,0,0,0,0,0,0,0,
0,0,0,0,0,0,0,0,0,0,0,
0,0,0,0,0,0,0,0,0,0,0.
[layer]
type=Tile Layer 2
data=
42,30,30,42,0,0,0,0,60,0,60,
42,30,42,0,0,42,42,0,60,0,60,
29,21,29,0,29,21,21,21,21,21,29,
33,24,33,0,0,33,24,24,24,24,33,
60,0,0,0,0,42,30,30,30,30,42,
60,0,42,42,0,0,0,0,0,42,42,
60,0,42,30,30,30,42,0,0,0,60,
70,0,70,70,70,70,70,70,70,0,0,
60,0,0,0,0,0,0,0,0,0,0,
0,0,0,0,0,0,0,0,0,0,0,
0,0,0,0,0,0,0,0,0,0,0.