[layer]
type=Tile Layer 1
data=
1,1,1,1,1,0,1,1,1,1,1,
2,1,21,0,1,1,0,1,2,1,1,
1,1,1,0,8,1,21,1,2,2,1,
1,1,1,0,1,1,1,1,1,1,1,
2,1,0,7,21,1,2,0,0,0,1,
1,1,1,1,0,0,0,0,0,0,1,
1,1,1,1,21,0,0,1,1,1,1,
1,1,0,0,1,1,0,0,0,21,1,
1,0,0,1,1,1,1,1,1,21,0,
0,0,0,0,0,0,0,0,0,0,0,
0,0,0,0,0,0,0,0,0,0,0,
0,0,0,0,0,0,0,0,0,0,0,
0,0,0,0,0,0,0,0,0,0,0.
[layer]
type=Tile Layer 2
data=
32,32,32,32,32,0,32,32,32,32,32,
41,41,0,0,41,41,0,41,41,41,41,
54,54,54,0,0,54,0,54,54,54,54,
28,28,28,0,28,28,28,28,28,28,28,
58,58,0,0,0,58,58,0,0,0,58,
38,38,38,38,0,0,0,0,0,0,38,
35,35,35,35,0,0,0,35,35,35,35,
37,37,0,0,37,37,0,0,0,0,37,
37,0,0,37,37,37,37,37,37,0,0,
0,0,0,0,0,0,0,0,0,0,0,
0,0,0,0,0,0,0,0,0,0,0,
0,0,0,0,0,0,0,0,0,0,0,
0,0,0,0,0,0,0,0,0,0,0.