[layer]
type=Tile Layer 1
data=
0,1,0,1,0,1,3,5,0,1,0,
1,0,1,0,1,0,1,3,5,0,1,
8,1,1,1,1,1,1,1,7,1,8,
1,1,1,1,1,1,6,24,4,1,1,
1,1,1,0,1,6,7,4,1,0,1,
1,1,0,1,6,7,4,1,0,1,1,
1,0,1,6,7,4,1,0,1,1,1,
12,12,1,7,4,12,12,12,12,12,12,
0,0,13,13,0,0,0,0,0,0,0,
0,0,0,0,0,0,0,0,0,0,0,
0,0,0,0,0,0,0,0,0,0,0,
0,0,0,0,0,0,0,0,0,0,0,
0,0,0,0,0,0,0,0,0,0,0.
[layer]
type=Tile Layer 2
data=
30,30,30,30,30,30,30,30,30,30,30,
30,30,30,30,30,30,30,30,30,30,30,
0,30,30,30,30,30,30,30,0,30,0,
30,30,30,10,30,30,30,0,30,10,30,
30,30,30,0,30,30,0,30,30,0,30,
30,30,0,30,30,0,30,30,0,30,30,
30,0,30,30,0,30,30,0,30,30,30,
1,1,30,0,30,1,1,1,1,1,1,
0,0,5,2,0,0,0,0,0,0,0,
0,0,0,0,0,0,0,0,0,0,0,
0,0,0,0,0,0,0,0,0,0,0,
0,0,0,0,0,0,0,0,0,0,0,
0,0,0,0,0,0,0,0,0,0,0.
