[layer]
type=Tile Layer 1
data=
1,3,1,0,4,1,0,1,1,1,0,
1,1,1,0,1,1,0,1,1,1,1,
1,9,1,0,1,1,0,6,1,1,1,
1,1,1,0,1,0,0,0,1,9,1,
0,0,0,0,1,1,3,5,1,1,1,
0,1,1,0,1,9,3,0,0,0,1,
0,1,1,1,1,4,1,1,0,0,1,
0,1,1,0,6,1,1,1,0,0,0,
0,0,0,0,0,0,0,0,0,0,0,
0,0,0,0,0,0,0,0,0,0,0,
0,0,0,0,0,0,0,0,0,0,0.
[layer]
type=Tile Layer 2
data=
42,30,42,0,42,42,0,42,42,0,0,
33,24,33,0,33,33,0,33,24,24,33,
33,24,33,0,33,33,0,33,24,24,33,
42,30,42,0,60,0,0,0,42,30,42,
0,0,0,0,42,30,30,30,30,30,42,
0,42,42,0,42,30,42,0,0,0,60,
0,33,24,24,24,24,24,33,0,0,33,
0,60,60,0,60,60,60,60,0,0,0,
0,0,0,0,0,0,0,0,0,0,0,
0,0,0,0,0,0,0,0,0,0,0,
0,0,0,0,0,0,0,0,0,0,0.