[layer]
type=Tile Layer 1
data=
0,0,0,1,1,1,0,0,21,1,1,
1,1,1,0,0,7,1,2,2,0,21,
1,1,2,0,0,0,2,1,1,24,21,
0,0,0,1,1,1,0,0,21,1,1,
0,0,0,1,1,1,0,0,21,1,1,
1,1,1,0,0,21,1,1,1,0,0,
1,1,2,0,0,21,1,1,2,0,0,
0,0,21,1,1,1,0,0,0,1,1,
0,0,21,1,1,1,0,0,0,1,1,
0,0,0,0,0,0,0,0,0,0,0,
0,0,0,0,0,0,0,0,0,0,0,
0,0,0,0,0,0,0,0,0,0,0,
0,0,0,0,0,0,0,0,0,0,0.
[layer]
type=Tile Layer 2
data=
0,0,0,74,74,74,0,0,0,74,74,
109,109,109,0,0,0,109,109,109,0,0,
97,97,97,0,0,0,97,97,97,0,0,
0,0,0,64,64,64,0,0,0,64,64,
0,0,0,63,63,63,0,0,0,63,63,
62,62,62,0,0,0,62,62,62,0,0,
61,61,61,0,0,0,61,61,61,0,0,
0,0,0,60,60,60,0,0,0,60,60,
0,0,0,59,59,59,0,0,0,59,59,
0,0,0,0,0,0,0,0,0,0,0,
0,0,0,0,0,0,0,0,0,0,0,
0,0,0,0,0,0,0,0,0,0,0,
0,0,0,0,0,0,0,0,0,0,0.