[layer]
type=Tile Layer 1
data=
1,0,0,0,0,0,0,0,0,0,1,
1,0,1,1,1,1,1,1,1,0,1,
0,1,1,1,1,1,1,1,1,1,0,
0,0,1,21,21,1,21,21,1,0,0,
0,0,1,1,21,1,21,1,1,0,0,
0,0,1,1,21,1,21,1,1,0,0,
0,0,0,1,21,0,21,1,0,0,0,
0,0,0,0,1,0,1,0,0,0,0,
1,1,1,1,0,0,0,1,1,1,1,
0,0,0,0,0,0,0,0,0,0,0,
0,0,0,0,0,0,0,0,0,0,0,
0,0,0,0,0,0,0,0,0,0,0,
0,0,0,0,0,0,0,0,0,0,0.
[layer]
type=Tile Layer 2
data=
74,0,0,0,0,0,0,0,0,0,74,
67,0,67,67,67,67,67,67,67,0,67,
0,60,60,60,60,60,60,60,60,60,0,
0,0,67,0,0,67,0,0,67,0,0,
0,0,63,63,0,63,0,63,63,0,0,
0,0,61,61,0,61,0,61,61,0,0,
0,0,0,59,0,0,0,59,0,0,0,
0,0,0,0,58,0,58,0,0,0,0,
58,58,58,58,0,0,0,58,58,58,58,
0,0,0,0,0,0,0,0,0,0,0,
0,0,0,0,0,0,0,0,0,0,0,
0,0,0,0,0,0,0,0,0,0,0,
0,0,0,0,0,0,0,0,0,0,0.