[layer]
type=Tile Layer 1
data=
1,1,1,3,1,1,6,21,6,1,1,
1,4,4,1,1,5,21,0,0,1,1,
1,1,3,1,21,0,0,0,6,0,1,
1,1,1,6,21,1,0,0,0,6,0,
3,3,1,21,0,0,0,0,0,1,0,
0,1,3,21,0,0,0,0,0,1,0,
0,0,3,4,21,0,21,0,21,21,1,
0,0,0,0,0,0,0,0,0,0,0,
0,0,0,0,0,0,0,0,0,0,0,
0,0,0,0,0,0,0,0,0,0,0,
0,0,0,0,0,0,0,0,0,0,0.
[layer]
type=Tile Layer 2
data=
46,46,46,46,46,46,46,0,46,46,46,
56,56,56,56,56,56,0,0,0,56,56,
55,55,55,55,0,0,0,0,55,0,55,
54,54,54,54,0,54,0,0,0,54,0,
53,53,53,0,0,0,0,0,0,53,0,
0,52,52,0,0,0,0,0,0,52,0,
0,0,51,51,0,0,0,0,0,0,51,
0,0,0,0,0,0,0,0,0,0,0,
0,0,0,0,0,0,0,0,0,0,0,
0,0,0,0,0,0,0,0,0,0,0,
0,0,0,0,0,0,0,0,0,0,0.