[layer]
type=Tile Layer 1
data=
0,1,2,1,1,1,1,1,2,2,1,
1,1,1,1,0,1,21,1,1,1,1,
0,1,0,0,0,1,0,0,21,2,0,
0,1,0,1,0,1,1,1,21,1,1,
0,1,0,1,0,0,1,1,0,0,0,
1,1,1,1,1,1,0,1,1,1,1,
1,1,1,1,0,1,21,1,1,1,0,
1,1,1,0,1,1,1,1,1,1,1,
0,1,0,1,1,1,21,1,0,1,1,
0,1,0,0,0,1,21,0,0,2,0,
1,1,1,1,24,1,1,1,1,1,21,
21,0,1,1,0,1,0,0,0,1,0,
0,1,1,1,21,1,0,1,0,1,1,
21,0,0,1,0,0,0,1,0,0,0,
1,1,21,1,1,1,1,1,1,1,0,
0,0,0,0,0,0,0,0,0,0,0,
0,0,0,0,0,0,0,0,0,0,0,
0,0,0,0,0,0,0,0,0,0,0,
0,0,0,0,0,0,0,0,0,0,0.
[layer]
type=Tile Layer 2
data=
0,53,53,53,53,53,53,53,53,53,53,
60,60,60,60,0,60,0,60,60,60,60,
0,69,0,0,0,69,0,0,0,69,0,
0,67,0,67,0,67,67,67,0,67,67,
0,66,0,66,0,0,66,66,0,0,0,
43,43,43,43,43,43,0,43,43,43,43,
55,55,55,55,0,55,0,55,55,55,0,
42,42,42,0,42,42,42,42,42,42,42,
0,54,0,54,54,54,0,54,0,54,54,
0,53,0,0,0,53,0,0,0,53,0,
63,63,63,63,0,63,63,63,63,63,0,
0,0,51,51,0,51,0,0,0,51,0,
0,50,50,50,0,50,0,50,0,50,50,
0,0,0,49,0,0,0,49,0,0,0,
39,39,0,39,39,39,39,39,39,39,0,
0,0,0,0,0,0,0,0,0,0,0,
0,0,0,0,0,0,0,0,0,0,0,
0,0,0,0,0,0,0,0,0,0,0,
0,0,0,0,0,0,0,0,0,0,0.