[layer]
type=Tile Layer 1
data=
0,0,1,1,0,0,0,0,1,21,0,
2,0,1,1,1,1,2,1,1,21,1,
1,0,21,0,0,0,1,1,0,0,1,
1,1,1,1,0,1,2,1,1,2,1,
1,1,0,0,1,0,0,0,1,21,0,
1,1,1,21,1,1,1,0,1,1,1,
0,0,0,21,0,0,1,0,0,0,1,
1,1,1,1,1,0,1,1,1,21,1,
1,1,0,0,0,0,0,0,1,0,1,
0,0,0,0,0,0,0,0,0,0,0,
0,0,0,0,0,0,0,0,0,0,0,
0,0,0,0,0,0,0,0,0,0,0,
0,0,0,0,0,0,0,0,0,0,0.
[layer]
type=Tile Layer 2
data=
0,0,46,46,0,0,0,0,46,0,0,
36,0,36,36,36,36,36,36,36,0,36,
40,0,0,0,0,0,40,40,0,0,40,
28,28,28,28,0,28,28,28,28,28,28,
39,39,0,0,39,0,0,0,39,0,0,
30,30,30,0,30,30,30,0,30,30,30,
0,0,0,0,0,0,37,0,0,0,37,
29,29,29,29,29,0,29,29,29,0,29,
37,37,0,0,0,0,0,0,37,0,37,
0,0,0,0,0,0,0,0,0,0,0,
0,0,0,0,0,0,0,0,0,0,0,
0,0,0,0,0,0,0,0,0,0,0,
0,0,0,0,0,0,0,0,0,0,0.