[layer]
type=Tile Layer 1
data=
0,2,2,2,0,21,0,2,2,2,21,
0,2,2,2,0,21,0,2,2,2,0,
21,7,2,0,0,0,0,0,2,8,0,
0,20,9,0,0,0,0,0,9,20,21,
0,20,9,1,1,21,1,1,1,20,0,
0,20,9,1,1,21,1,1,1,20,0,
0,20,20,9,0,21,0,9,20,20,0,
0,20,20,20,11,11,11,20,20,20,0,
0,0,0,0,0,0,0,0,0,0,0,
0,0,0,0,0,0,0,0,0,0,0,
0,0,0,0,0,0,0,0,0,0,0.
[layer]
type=Tile Layer 2
data=
0,36,36,36,0,0,0,36,36,36,0,
0,35,35,35,0,0,0,35,35,35,0,
0,0,68,0,0,0,0,0,68,0,0,
0,0,33,0,0,0,0,0,33,0,0,
0,0,29,29,29,0,29,29,29,0,0,
0,0,28,28,28,0,28,28,28,0,0,
0,0,0,31,0,0,0,31,0,0,0,
0,0,0,0,25,25,25,0,0,0,0,
0,0,0,0,0,0,0,0,0,0,0,
0,0,0,0,0,0,0,0,0,0,0,
0,0,0,0,0,0,0,0,0,0,0.