[layer]
type=Tile Layer 1
data=
0,0,0,1,0,0,0,1,0,21,0,
1,1,21,1,0,1,1,1,0,1,1,
0,1,0,1,0,1,1,0,0,0,0,
1,1,0,1,0,1,1,1,1,1,21,
0,0,0,1,0,0,0,1,1,1,21,
1,1,1,1,1,1,0,1,0,1,21,
0,1,1,0,21,0,0,1,0,1,0,
21,1,1,1,0,1,1,1,0,1,1,
1,1,1,1,1,1,0,1,1,1,1,
1,1,1,1,1,1,0,1,21,1,1,
0,0,0,21,0,1,0,0,0,1,0,
1,1,1,1,1,1,1,1,0,1,1,
1,1,21,1,1,1,1,1,1,1,0,
0,0,0,1,0,0,0,0,21,1,0,
0,1,1,1,0,1,1,1,0,1,0,
0,0,0,0,0,0,0,0,0,0,0,
0,0,0,0,0,0,0,0,0,0,0,
0,0,0,0,0,0,0,0,0,0,0,
0,0,0,0,0,0,0,0,0,0,0.
[layer]
type=Tile Layer 2
data=
0,0,0,75,0,0,0,75,0,0,0,
66,66,0,66,0,66,66,66,0,66,66,
0,66,0,66,0,66,66,0,0,0,0,
60,60,0,60,0,60,60,60,60,60,0,
0,0,0,65,0,0,0,65,65,65,0,
53,53,53,53,53,53,0,53,0,53,0,
0,58,58,0,0,0,0,58,0,58,0,
0,51,51,51,0,51,51,51,0,51,51,
35,35,35,35,35,35,0,35,35,35,35,
40,40,40,40,40,40,0,40,0,40,40,
0,0,0,0,0,49,0,0,0,49,0,
34,34,34,34,34,34,34,34,0,34,34,
38,38,0,38,38,38,38,38,38,38,0,
0,0,0,47,0,0,0,0,0,47,0,
0,47,47,47,0,47,47,47,0,47,0,
0,0,0,0,0,0,0,0,0,0,0,
0,0,0,0,0,0,0,0,0,0,0,
0,0,0,0,0,0,0,0,0,0,0,
0,0,0,0,0,0,0,0,0,0,0.