[layer]
type=Tile Layer 1
data=
1,1,1,0,0,21,1,6,1,3,1,
1,1,0,0,1,1,1,5,0,6,1,
0,4,21,1,0,1,0,1,1,4,0,
1,6,1,5,0,0,0,21,0,1,0,
6,1,21,0,0,0,0,0,0,0,1,
1,1,5,1,6,3,1,1,1,0,1,
4,1,0,0,0,1,21,1,0,4,1,
21,1,5,1,5,0,1,1,0,1,1,
0,1,1,5,1,4,1,1,0,21,1,
1,3,1,3,0,0,0,1,21,0,1,
1,5,1,0,0,21,0,0,0,0,0,
1,1,0,3,1,0,0,0,0,0,21,
1,0,0,0,21,0,0,0,0,0,0,
0,0,0,21,0,0,0,0,1,4,1,
0,0,21,0,0,0,0,0,1,4,1,
1,0,21,1,0,0,0,0,4,1,0,
1,1,1,0,1,3,1,5,4,1,1,
1,6,1,0,0,21,1,1,6,1,1,
1,0,1,3,21,0,1,4,0,0,1,
0,0,0,0,0,0,0,0,0,0,0,
0,0,0,0,0,0,0,0,0,0,0,
0,0,0,0,0,0,0,0,0,0,0,
0,0,0,0,0,0,0,0,0,0,0.
[layer]
type=Tile Layer 2
data=
78,78,78,0,0,0,78,78,78,78,78,
77,77,0,0,77,77,77,77,0,77,77,
0,86,0,86,0,86,0,86,86,86,0,
92,92,92,92,0,0,0,0,0,92,0,
91,91,0,0,0,0,0,0,0,0,91,
64,64,64,64,64,64,64,64,64,0,64,
83,83,0,0,0,83,0,83,0,83,83,
0,73,73,73,73,0,73,73,0,73,73,
0,73,73,73,73,73,73,73,0,0,73,
73,73,73,73,0,0,0,73,0,0,73,
72,72,72,0,0,0,0,0,0,0,0,
71,71,0,71,71,0,0,0,0,0,0,
63,0,0,0,0,0,0,0,0,0,0,
0,0,0,0,0,0,0,0,62,62,62,
0,0,0,0,0,0,0,0,61,61,61,
60,0,0,60,0,0,0,0,60,60,0,
42,42,42,0,42,42,42,42,42,42,42,
53,53,53,0,0,0,53,53,53,53,53,
58,0,58,58,0,0,58,58,0,0,58,
0,0,0,0,0,0,0,0,0,0,0,
0,0,0,0,0,0,0,0,0,0,0,
0,0,0,0,0,0,0,0,0,0,0,
0,0,0,0,0,0,0,0,0,0,0.