[layer]
type=Tile Layer 1
data=
21,0,0,0,0,0,3,1,4,1,1,
0,6,6,1,1,1,1,0,0,21,1,
21,0,0,0,0,0,1,3,4,1,1,
0,1,1,1,3,5,1,21,0,0,1,
0,21,0,0,0,0,6,5,1,1,1,
21,1,1,3,6,1,1,0,0,0,1,
0,0,21,0,0,0,6,1,1,5,1,
1,6,1,1,3,0,21,0,0,0,0,
0,0,0,0,0,6,1,4,1,1,21,
1,1,5,3,1,0,0,21,0,0,0,
0,0,0,0,0,1,5,1,4,1,21,
1,1,1,5,6,0,21,0,0,0,0,
0,21,0,0,0,1,4,4,1,1,0,
0,0,0,0,0,0,21,0,0,0,0,
0,0,0,0,0,0,0,0,0,0,0,
0,0,0,0,0,0,0,0,0,0,0,
0,0,0,0,0,0,0,0,0,0,0.
[layer]
type=Tile Layer 2
data=
0,0,0,0,0,0,72,72,72,72,72,
0,71,71,71,71,71,71,0,0,0,71,
0,0,0,0,0,0,70,70,70,70,70,
0,63,63,63,63,63,63,0,0,0,63,
0,0,0,0,0,0,62,62,62,62,62,
0,61,61,61,61,61,61,0,0,0,61,
0,0,0,0,0,0,54,54,54,54,54,
53,53,53,53,53,0,0,0,0,0,0,
0,0,0,0,0,52,52,52,52,52,0,
51,51,51,51,51,0,0,0,0,0,0,
0,0,0,0,0,50,50,50,50,50,0,
49,49,49,49,49,0,0,0,0,0,0,
0,0,0,0,0,48,48,48,48,48,0,
0,0,0,0,0,0,0,0,0,0,0,
0,0,0,0,0,0,0,0,0,0,0,
0,0,0,0,0,0,0,0,0,0,0,
0,0,0,0,0,0,0,0,0,0,0.