[layer]
type=Tile Layer 1
data=
0,0,0,0,1,1,1,1,1,7,0,
0,0,0,2,1,0,21,0,7,1,0,
0,0,2,1,0,21,2,0,0,1,1,
0,1,1,0,21,1,21,1,0,1,1,
1,1,8,21,2,21,2,1,0,1,1,
1,0,21,1,21,1,1,0,0,1,0,
1,0,1,21,1,1,0,0,1,1,0,
1,0,21,1,1,0,0,1,1,0,0,
1,1,1,1,0,0,1,1,0,7,0,
0,0,0,0,0,0,0,0,0,0,0,
0,0,0,0,0,0,0,0,0,0,0,
0,0,0,0,0,0,0,0,0,0,0,
0,0,0,0,0,0,0,0,0,0,0.
[layer]
type=Tile Layer 2
data=
0,0,0,0,111,111,111,111,111,0,0,
0,0,0,111,111,0,0,0,0,111,0,
0,0,66,66,0,0,66,0,0,66,66,
0,65,65,0,0,65,0,65,0,65,65,
94,94,0,0,94,0,94,94,0,94,94,
61,0,0,61,0,61,61,0,0,61,0,
59,0,59,0,59,59,0,0,59,59,0,
58,0,0,58,58,0,0,58,58,0,0,
87,87,87,87,0,0,87,87,0,0,0,
0,0,0,0,0,0,0,0,0,0,0,
0,0,0,0,0,0,0,0,0,0,0,
0,0,0,0,0,0,0,0,0,0,0,
0,0,0,0,0,0,0,0,0,0,0.