[layer]
type=Tile Layer 1
data=
0,2,0,21,0,0,0,2,0,2,0,
0,1,1,1,1,1,2,1,21,1,1,
0,21,2,2,0,0,0,2,0,0,0,
1,1,1,1,1,1,1,1,21,1,1,
0,0,0,21,0,0,0,2,2,2,2,
21,1,1,1,1,1,1,1,1,1,1,
1,1,21,0,0,0,0,1,0,0,0,
1,1,0,1,1,1,1,1,1,1,21,
0,0,0,1,1,0,0,0,1,1,21,
0,0,0,0,0,0,0,0,0,0,0,
0,0,0,0,0,0,0,0,0,0,0,
0,0,0,0,0,0,0,0,0,0,0,
0,0,0,0,0,0,0,0,0,0,0.
[layer]
type=Tile Layer 2
data=
0,47,0,0,0,0,0,47,0,47,0,
0,37,37,37,37,37,37,37,0,37,37,
0,0,40,40,0,0,0,40,0,0,0,
27,27,27,27,27,27,27,27,0,27,27,
0,0,0,0,0,0,0,39,39,39,39,
0,27,27,27,27,27,27,27,27,27,27,
37,37,0,0,0,0,0,37,0,0,0,
29,29,0,29,29,29,29,29,29,29,0,
0,0,0,36,36,0,0,0,36,36,0,
0,0,0,0,0,0,0,0,0,0,0,
0,0,0,0,0,0,0,0,0,0,0,
0,0,0,0,0,0,0,0,0,0,0,
0,0,0,0,0,0,0,0,0,0,0.