[layer]
type=Tile Layer 1
data=
21,1,1,1,1,1,0,1,0,0,0,
21,1,1,1,1,1,0,1,0,0,0,
0,1,1,1,1,1,0,1,0,21,0,
0,1,1,1,0,1,1,1,0,21,0,
0,1,1,1,0,0,0,1,0,0,0,
0,1,1,1,1,1,1,1,1,1,21,
0,1,0,21,0,1,1,1,1,1,0,
21,1,1,1,1,1,1,1,1,1,1,
1,1,1,1,1,1,1,1,1,0,1,
0,0,0,0,21,1,1,1,1,1,0,
21,0,0,0,0,1,1,1,0,1,1,
0,0,0,0,0,1,1,1,21,1,1,
1,1,1,1,1,1,1,1,21,1,1,
0,1,1,1,0,1,1,1,21,0,0,
1,1,1,1,1,1,0,1,1,1,1,
0,0,0,0,0,0,0,0,0,0,0,
0,0,0,0,0,0,0,0,0,0,0,
0,0,0,0,0,0,0,0,0,0,0,
0,0,0,0,0,0,0,0,0,0,0.
[layer]
type=Tile Layer 2
data=
0,76,76,76,76,76,0,76,0,0,0,
0,75,75,75,75,75,0,75,0,0,0,
0,68,68,68,68,68,0,68,0,0,0,
0,66,66,66,0,66,66,66,0,0,0,
0,65,65,65,0,0,0,65,0,0,0,
0,48,48,48,48,48,48,48,48,48,0,
0,59,0,0,0,59,59,59,59,59,0,
0,41,41,41,41,41,41,41,41,41,41,
36,36,36,36,36,36,36,36,36,0,36,
0,0,0,0,0,51,51,51,51,51,0,
0,0,0,0,0,50,50,50,0,50,50,
0,0,0,0,0,49,49,49,0,49,49,
34,34,34,34,34,34,34,34,0,34,34,
0,47,47,47,0,47,47,47,0,0,0,
33,33,33,33,33,33,0,33,33,33,33,
0,0,0,0,0,0,0,0,0,0,0,
0,0,0,0,0,0,0,0,0,0,0,
0,0,0,0,0,0,0,0,0,0,0,
0,0,0,0,0,0,0,0,0,0,0.