[layer]
type=Tile Layer 1
data=
0,0,0,4,1,0,1,3,0,0,0,
0,0,0,5,6,0,5,6,0,0,0,
0,0,5,6,0,21,0,5,6,0,0,
7,8,4,3,0,1,0,4,3,0,0,
21,6,5,0,1,1,1,0,6,5,21,
21,3,4,0,5,1,6,24,3,4,21,
0,0,5,6,0,1,0,5,6,0,0,
0,21,4,3,0,0,0,4,3,21,0,
0,0,4,3,0,0,0,4,3,0,0,
0,0,0,0,0,0,0,0,0,0,0,
0,0,0,0,0,0,0,0,0,0,0,
0,0,0,0,0,0,0,0,0,0,0,
0,0,0,0,0,0,0,0,0,0,0.
[layer]
type=Tile Layer 2
data=
0,0,0,55,55,0,55,55,0,0,0,
0,0,0,55,55,0,55,55,0,0,0,
0,0,49,49,0,0,0,49,49,0,0,
0,0,96,96,0,96,0,96,96,0,0,
0,48,48,0,48,48,48,0,48,48,0,
0,69,69,0,69,69,69,0,69,69,0,
0,0,45,45,0,45,0,45,45,0,0,
0,0,45,45,0,0,0,45,45,0,0,
0,0,43,43,0,0,0,43,43,0,0,
0,0,0,0,0,0,0,0,0,0,0,
0,0,0,0,0,0,0,0,0,0,0,
0,0,0,0,0,0,0,0,0,0,0,
0,0,0,0,0,0,0,0,0,0,0.