[layer]
type=Tile Layer 1
data=
1,1,1,1,1,0,1,1,1,1,1,
1,1,1,1,1,8,0,21,1,1,1,
1,1,1,1,1,0,0,21,0,0,0,
0,1,1,1,0,0,0,1,21,0,0,
1,1,1,1,21,7,0,0,0,0,0,
1,1,1,0,0,0,0,1,21,0,1,
0,1,0,0,8,0,21,1,0,1,1,
0,21,0,0,1,0,1,0,0,1,0,
0,0,0,0,0,0,0,1,1,1,0,
0,0,0,1,21,0,0,1,1,1,0,
1,0,1,0,0,21,0,1,0,1,1,
1,1,1,0,21,0,0,0,1,1,1,
0,1,0,0,21,1,0,0,0,1,1,
0,0,0,0,0,0,0,0,0,0,0,
0,0,0,0,0,0,0,0,0,0,0,
0,0,0,0,0,0,0,0,0,0,0,
0,0,0,0,0,0,0,0,0,0,0.
[layer]
type=Tile Layer 2
data=
48,48,48,48,48,0,48,48,48,48,48,
91,91,91,91,91,0,0,0,91,91,91,
68,68,68,68,68,0,0,0,0,0,0,
0,61,61,61,0,0,0,61,0,0,0,
90,90,90,90,0,0,0,0,0,0,0,
59,59,59,0,0,0,0,59,0,0,59,
0,78,0,0,0,0,0,78,0,78,78,
0,0,0,0,51,0,51,0,0,51,0,
0,0,0,0,0,0,0,50,50,50,0,
0,0,0,50,0,0,0,50,50,50,0,
49,0,49,0,0,0,0,49,0,49,49,
48,48,48,0,0,0,0,0,48,48,48,
0,47,0,0,0,47,0,0,0,47,47,
0,0,0,0,0,0,0,0,0,0,0,
0,0,0,0,0,0,0,0,0,0,0,
0,0,0,0,0,0,0,0,0,0,0,
0,0,0,0,0,0,0,0,0,0,0.