[layer]
type=Tile Layer 1
data=
0,1,16,16,0,0,0,0,0,0,0,
0,17,1,1,17,0,0,0,0,0,0,
1,1,1,1,1,0,24,0,0,0,0,
0,1,1,1,1,0,21,21,1,1,1,
0,0,1,1,21,21,21,1,0,0,0,
0,0,17,1,21,21,21,1,7,0,0,
0,1,1,1,1,1,1,1,0,0,0,
1,1,1,1,1,1,1,1,1,0,0,
1,1,1,1,1,1,1,1,1,0,0,
0,0,0,0,0,0,0,0,0,0,0,
0,0,0,0,0,0,0,0,0,0,0,
0,0,0,0,0,0,0,0,0,0,0,
0,0,0,0,0,0,0,0,0,0,0.
[layer]
type=Tile Layer 2
data=
0,83,41,41,0,0,0,0,0,0,0,
0,41,83,83,41,0,0,0,0,0,0,
112,112,112,112,112,0,0,0,0,0,0,
0,75,75,75,75,0,0,0,75,75,75,
0,0,73,73,0,0,0,73,0,0,0,
0,0,52,105,0,0,0,105,0,0,0,
0,68,68,68,68,68,68,68,0,0,0,
68,68,68,68,68,68,68,68,68,0,0,
68,68,68,68,68,68,68,68,68,0,0,
0,0,0,0,0,0,0,0,0,0,0,
0,0,0,0,0,0,0,0,0,0,0,
0,0,0,0,0,0,0,0,0,0,0,
0,0,0,0,0,0,0,0,0,0,0.