[layer]
type=Tile Layer 1
data=
1,1,1,1,1,1,1,1,1,1,0,
0,21,0,0,0,0,1,1,1,1,0,
1,0,0,0,1,0,0,1,1,21,0,
1,0,0,21,0,0,0,1,1,0,0,
1,1,1,1,0,0,1,1,1,0,21,
21,1,1,1,0,1,0,0,0,0,0,
1,1,1,1,1,1,1,0,1,1,1,
0,1,1,0,0,0,0,1,21,0,1,
1,0,0,1,1,0,0,0,0,21,1,
0,21,0,1,1,1,0,0,0,0,0,
0,0,0,0,1,1,0,0,21,0,1,
1,0,0,0,0,0,1,1,1,0,0,
21,1,1,1,0,1,1,1,1,1,0,
1,1,1,1,1,21,1,1,1,1,0,
1,0,1,1,1,0,0,0,1,21,1,
0,0,1,1,1,0,0,21,0,1,1,
1,21,0,1,1,1,0,0,0,0,1,
1,1,1,1,21,0,1,0,0,1,0,
1,1,1,1,1,0,0,0,21,0,1,
0,0,0,0,0,0,0,0,0,0,0,
0,0,0,0,0,0,0,0,0,0,0,
0,0,0,0,0,0,0,0,0,0,0,
0,0,0,0,0,0,0,0,0,0,0.
[layer]
type=Tile Layer 2
data=
62,62,62,62,62,62,62,62,62,62,0,
0,0,0,0,0,0,87,87,87,87,0,
86,0,0,0,86,0,0,86,86,0,0,
92,0,0,0,0,0,0,92,92,0,0,
91,91,91,91,0,0,91,91,91,0,0,
0,90,90,90,0,90,0,0,0,0,0,
57,57,57,57,57,57,57,0,57,57,57,
0,82,82,0,0,0,0,82,0,0,82,
81,0,0,81,81,0,0,0,0,0,81,
0,0,0,73,73,73,0,0,0,0,0,
0,0,0,0,72,72,0,0,0,0,72,
71,0,0,0,0,0,71,71,71,0,0,
0,58,58,58,0,58,58,58,58,58,0,
50,50,50,50,50,0,50,50,50,50,0,
62,0,62,62,62,0,0,0,62,0,62,
0,0,61,61,61,0,0,0,0,61,61,
60,0,0,60,60,60,0,0,0,0,60,
59,59,59,59,0,0,59,0,0,59,0,
58,58,58,58,58,0,0,0,0,0,58,
0,0,0,0,0,0,0,0,0,0,0,
0,0,0,0,0,0,0,0,0,0,0,
0,0,0,0,0,0,0,0,0,0,0,
0,0,0,0,0,0,0,0,0,0,0.