[layer]
type=Tile Layer 1
data=
0,1,16,1,1,1,1,1,1,16,21,
7,21,1,1,1,1,1,1,1,0,0,
0,0,0,1,1,1,1,16,21,0,0,
0,0,0,21,1,1,1,0,0,0,0,
0,0,0,0,0,1,21,0,0,0,0,
0,1,0,1,0,21,0,1,0,1,0,
1,1,1,1,0,21,0,1,1,1,1,
0,0,0,0,0,1,0,0,0,0,0,
0,21,1,1,1,1,1,1,1,21,0,
0,0,0,0,0,0,0,0,0,0,0,
0,0,0,0,0,0,0,0,0,0,0,
0,0,0,0,0,0,0,0,0,0,0,
0,0,0,0,0,0,0,0,0,0,0.
[layer]
type=Tile Layer 2
data=
0,49,24,49,49,49,49,49,49,24,0,
0,0,90,90,90,90,90,90,90,0,0,
0,0,0,53,53,53,53,26,0,0,0,
0,0,0,0,52,52,52,0,0,0,0,
0,0,0,0,0,51,0,0,0,0,0,
0,50,0,50,0,0,0,50,0,50,0,
44,44,44,44,0,0,0,44,44,44,44,
0,0,0,0,0,48,0,0,0,0,0,
0,0,48,48,48,48,48,48,48,0,0,
0,0,0,0,0,0,0,0,0,0,0,
0,0,0,0,0,0,0,0,0,0,0,
0,0,0,0,0,0,0,0,0,0,0,
0,0,0,0,0,0,0,0,0,0,0.