[layer]
type=Tile Layer 1
data=
1,1,1,1,1,1,1,1,1,0,1,
2,1,2,21,0,0,0,0,0,0,0,
2,2,1,0,0,21,0,0,7,0,1,
1,1,0,0,21,0,1,0,0,0,0,
0,0,0,0,1,1,1,1,21,0,0,
0,0,0,1,0,1,1,1,0,0,1,
0,1,0,0,1,1,1,0,0,0,21,
0,0,0,0,0,2,0,1,0,21,1,
0,0,21,1,0,8,0,0,2,0,1,
1,0,21,24,1,1,0,0,1,1,0,
1,1,0,1,0,21,0,1,1,1,1,
1,1,1,1,1,1,1,1,1,0,1,
1,21,1,0,0,1,2,2,1,1,1,
1,0,0,0,0,0,0,1,1,1,21,
0,0,0,21,0,1,0,0,1,1,0,
1,0,0,1,0,21,0,0,1,0,0,
21,1,1,0,1,1,0,0,0,0,1,
0,0,0,0,0,0,0,0,0,0,0,
0,0,0,0,0,0,0,0,0,0,0,
0,0,0,0,0,0,0,0,0,0,0,
0,0,0,0,0,0,0,0,0,0,0.
[layer]
type=Tile Layer 2
data=
52,52,52,52,52,52,52,52,52,0,52,
80,80,80,0,0,0,0,0,0,0,0,
118,118,118,0,0,0,0,0,0,0,118,
78,78,0,0,0,0,78,0,0,0,0,
0,0,0,0,71,71,71,71,0,0,0,
0,0,0,70,0,70,70,70,0,0,70,
0,70,0,0,70,70,70,0,0,0,0,
0,0,0,0,0,63,0,63,0,0,63,
0,0,0,93,0,0,0,0,93,0,93,
91,0,0,0,91,91,0,0,91,91,0,
54,54,0,54,0,0,0,54,54,54,54,
38,38,38,38,38,38,38,38,38,0,38,
48,0,48,0,0,48,48,48,48,48,48,
52,0,0,0,0,0,0,52,52,52,0,
0,0,0,0,0,51,0,0,51,51,0,
50,0,0,50,0,0,0,0,50,0,0,
0,49,49,0,49,49,0,0,0,0,49,
0,0,0,0,0,0,0,0,0,0,0,
0,0,0,0,0,0,0,0,0,0,0,
0,0,0,0,0,0,0,0,0,0,0,
0,0,0,0,0,0,0,0,0,0,0.