[layer]
type=Tile Layer 1
data=
0,1,1,1,1,1,1,1,1,1,0,
1,0,0,0,0,0,0,0,0,21,1,
1,0,1,1,1,0,1,1,1,21,1,
1,0,1,1,1,0,1,1,1,21,1,
1,0,1,1,1,0,1,1,1,21,1,
1,0,0,0,0,0,0,0,0,21,1,
1,0,0,1,1,1,1,1,0,21,1,
0,1,0,1,1,1,1,1,21,1,0,
0,1,0,0,0,0,0,0,21,1,0,
0,0,0,0,0,0,0,0,0,0,0,
0,0,0,0,0,0,0,0,0,0,0,
0,0,0,0,0,0,0,0,0,0,0,
0,0,0,0,0,0,0,0,0,0,0.
[layer]
type=Tile Layer 2
data=
0,83,83,83,83,83,83,83,83,83,0,
83,0,0,0,0,0,0,0,0,0,83,
74,0,74,74,74,0,74,74,74,0,74,
73,0,73,73,73,0,73,73,73,0,73,
72,0,72,72,72,0,72,72,72,0,72,
71,0,0,0,0,0,0,0,0,0,71,
70,0,0,70,70,70,70,70,0,0,70,
0,69,0,69,69,69,69,69,0,69,0,
0,68,0,0,0,0,0,0,0,68,0,
0,0,0,0,0,0,0,0,0,0,0,
0,0,0,0,0,0,0,0,0,0,0,
0,0,0,0,0,0,0,0,0,0,0,
0,0,0,0,0,0,0,0,0,0,0.