[layer]
type=Tile Layer 1
data=
2,2,1,2,21,0,1,1,4,0,0,
1,1,1,21,0,24,0,0,6,3,0,
1,2,21,0,0,2,5,0,0,3,1,
1,21,7,0,0,2,5,0,0,2,1,
1,21,0,0,0,0,0,0,3,5,1,
1,21,0,0,6,1,1,5,1,4,1,
3,21,0,1,4,0,0,1,1,1,1,
1,21,0,5,1,0,0,1,1,3,0,
1,1,21,0,4,1,3,1,1,0,0,
0,0,0,0,0,0,0,0,0,0,0,
0,0,0,0,0,0,0,0,0,0,0,
0,0,0,0,0,0,0,0,0,0,0,
0,0,0,0,0,0,0,0,0,0,0.
[layer]
type=Tile Layer 2
data=
85,85,85,85,0,0,85,85,85,0,0,
126,126,126,0,0,0,0,0,126,126,0,
75,75,0,0,0,75,75,0,0,75,75,
111,0,0,0,0,111,111,0,0,111,111,
73,0,0,0,0,0,0,0,73,73,73,
72,0,0,0,72,72,72,72,72,72,72,
71,0,0,71,71,0,0,71,71,71,71,
70,0,0,70,70,0,0,70,70,70,0,
69,69,0,0,69,69,69,69,69,0,0,
0,0,0,0,0,0,0,0,0,0,0,
0,0,0,0,0,0,0,0,0,0,0,
0,0,0,0,0,0,0,0,0,0,0,
0,0,0,0,0,0,0,0,0,0,0.