[layer]
type=Tile Layer 1
data=
0,0,1,1,1,1,1,1,1,0,0,
0,4,2,21,21,21,21,21,2,3,0,
0,1,0,4,1,1,1,3,0,1,0,
24,0,1,6,7,21,21,5,1,0,0,
0,4,6,24,4,1,3,0,5,3,0,
0,1,0,4,6,21,5,3,0,1,0,
0,0,0,1,0,0,0,1,0,0,0,
0,0,0,0,0,0,7,0,0,0,0,
0,0,0,4,1,1,1,3,0,0,0,
0,0,0,0,0,0,0,0,0,0,0,
0,0,0,0,0,0,0,0,0,0,0,
0,0,0,0,0,0,0,0,0,0,0,
0,0,0,0,0,0,0,0,0,0,0.
[layer]
type=Tile Layer 2
data=
0,0,46,46,46,46,46,46,46,0,0,
0,46,46,0,0,0,0,0,46,46,0,
0,37,0,37,37,37,37,37,0,37,0,
0,0,74,74,0,0,0,74,74,0,0,
0,54,54,0,54,54,54,0,54,54,0,
0,36,0,36,36,0,36,36,0,36,0,
0,0,0,36,0,0,0,36,0,0,0,
0,0,0,0,0,0,0,0,0,0,0,
0,0,0,36,36,36,36,36,0,0,0,
0,0,0,0,0,0,0,0,0,0,0,
0,0,0,0,0,0,0,0,0,0,0,
0,0,0,0,0,0,0,0,0,0,0,
0,0,0,0,0,0,0,0,0,0,0.