[layer]
type=Tile Layer 1
data=
0,0,0,0,0,0,1,0,1,1,0,
0,0,0,0,0,1,0,1,1,1,1,
1,1,0,0,0,1,0,1,1,1,1,
0,1,21,21,21,21,21,1,1,0,0,
0,0,1,1,1,1,1,1,1,0,0,
0,1,1,1,1,1,1,1,1,0,0,
0,1,1,1,21,21,21,1,1,1,0,
0,1,0,1,0,0,0,1,0,0,1,
1,0,0,1,0,0,0,0,1,0,1,
0,0,0,0,0,0,0,0,0,0,0,
0,0,0,0,0,0,0,0,0,0,0,
0,0,0,0,0,0,0,0,0,0,0,
0,0,0,0,0,0,0,0,0,0,0.
[layer]
type=Tile Layer 2
data=
0,0,0,0,0,0,72,0,72,72,0,
0,0,0,0,0,72,0,72,72,72,72,
65,65,0,0,0,65,0,65,65,65,65,
0,65,0,0,0,0,0,65,65,0,0,
0,0,60,60,60,60,60,60,60,0,0,
0,60,60,60,60,60,60,60,60,0,0,
0,60,60,60,0,0,0,60,60,60,0,
0,58,0,58,0,0,0,58,0,0,58,
58,0,0,58,0,0,0,0,58,0,58,
0,0,0,0,0,0,0,0,0,0,0,
0,0,0,0,0,0,0,0,0,0,0,
0,0,0,0,0,0,0,0,0,0,0,
0,0,0,0,0,0,0,0,0,0,0.