[layer]
type=Tile Layer 1
data=
0,0,0,1,1,0,1,2,0,0,0,
0,1,1,2,1,1,1,1,1,2,0,
1,21,1,1,1,1,1,1,1,21,1,
1,21,1,2,21,21,21,2,2,21,1,
0,1,1,0,1,1,1,0,1,1,0,
0,0,0,1,1,1,1,1,0,0,0,
8,1,1,1,21,21,21,1,1,1,0,
0,1,1,0,1,21,1,0,1,1,0,
0,0,1,0,1,1,1,0,1,0,0,
0,0,0,0,0,0,0,0,0,0,0,
0,0,0,0,0,0,0,0,0,0,0,
0,0,0,0,0,0,0,0,0,0,0,
0,0,0,0,0,0,0,0,0,0,0.
[layer]
type=Tile Layer 2
data=
0,0,0,87,87,0,87,87,0,0,0,
0,87,87,87,87,87,87,87,87,87,0,
78,0,78,78,78,78,78,78,78,0,78,
77,0,77,77,0,0,0,77,77,0,77,
0,72,72,0,72,72,72,0,72,72,0,
0,0,0,72,72,72,72,72,0,0,0,
0,108,108,108,0,0,0,108,108,108,0,
0,69,69,0,69,0,69,0,69,69,0,
0,0,69,0,69,69,69,0,69,0,0,
0,0,0,0,0,0,0,0,0,0,0,
0,0,0,0,0,0,0,0,0,0,0,
0,0,0,0,0,0,0,0,0,0,0,
0,0,0,0,0,0,0,0,0,0,0.