[layer]
type=Tile Layer 1
data=
1,1,1,1,0,21,1,1,0,0,0,
0,1,1,1,1,1,1,1,1,1,1,
1,1,1,1,1,2,1,1,2,0,21,
21,1,1,0,24,0,0,0,2,2,0,
0,21,0,1,0,0,0,1,0,1,1,
0,2,0,0,0,0,2,7,21,0,1,
1,1,1,0,1,0,21,0,0,1,0,
0,1,1,21,0,1,0,0,0,0,0,
1,0,0,1,0,0,0,21,1,0,1,
1,0,0,1,1,0,0,0,1,0,21,
0,0,21,0,1,1,1,0,0,0,1,
1,1,0,0,0,0,0,1,1,0,0,
0,1,21,0,0,0,0,1,1,1,0,
0,0,0,0,0,0,0,0,0,0,0,
0,0,0,0,0,0,0,0,0,0,0,
0,0,0,0,0,0,0,0,0,0,0,
0,0,0,0,0,0,0,0,0,0,0.
[layer]
type=Tile Layer 2
data=
69,69,69,69,0,0,69,69,0,0,0,
0,48,48,48,48,48,48,48,48,48,48,
54,54,54,54,54,54,54,54,54,0,0,
0,91,91,0,0,0,0,0,91,91,0,
0,0,0,60,0,0,0,60,0,60,60,
0,88,0,0,0,0,88,0,0,0,88,
52,52,52,0,52,0,0,0,0,52,0,
0,51,51,0,0,51,0,0,0,0,0,
50,0,0,50,0,0,0,0,50,0,50,
49,0,0,49,49,0,0,0,49,0,0,
0,0,0,0,48,48,48,0,0,0,48,
47,47,0,0,0,0,0,47,47,0,0,
0,47,0,0,0,0,0,47,47,47,0,
0,0,0,0,0,0,0,0,0,0,0,
0,0,0,0,0,0,0,0,0,0,0,
0,0,0,0,0,0,0,0,0,0,0,
0,0,0,0,0,0,0,0,0,0,0.