[layer]
type=Tile Layer 1
data=
0,1,1,1,1,1,1,1,1,21,0,
1,1,1,1,1,1,1,1,1,1,21,
1,0,0,1,1,1,1,0,1,1,21,
0,0,1,1,1,1,1,0,0,1,21,
0,1,1,1,1,1,1,1,21,0,0,
0,1,0,0,0,1,1,1,1,21,0,
0,1,0,0,1,1,1,1,1,21,0,
0,0,0,1,1,1,1,1,1,21,0,
0,0,1,1,1,1,0,1,1,21,0,
0,0,0,0,0,0,0,0,0,0,0,
0,0,0,0,0,0,0,0,0,0,0,
0,0,0,0,0,0,0,0,0,0,0,
0,0,0,0,0,0,0,0,0,0,0.
[layer]
type=Tile Layer 2
data=
0,85,85,85,85,85,85,85,85,0,0,
76,76,76,76,76,76,76,76,76,76,0,
75,0,0,75,75,75,75,0,75,75,0,
0,0,74,74,74,74,74,0,0,74,0,
0,73,73,73,73,73,73,73,0,0,0,
0,72,0,0,0,72,72,72,72,0,0,
0,71,0,0,71,71,71,71,71,0,0,
0,0,0,70,70,70,70,70,70,0,0,
0,0,69,69,69,69,0,69,69,0,0,
0,0,0,0,0,0,0,0,0,0,0,
0,0,0,0,0,0,0,0,0,0,0,
0,0,0,0,0,0,0,0,0,0,0,
0,0,0,0,0,0,0,0,0,0,0.