[layer]
type=Tile Layer 1
data=
0,0,0,1,1,0,0,0,1,1,0,
0,0,1,1,0,0,0,0,1,1,0,
0,1,0,0,0,0,1,0,0,0,0,
1,0,0,0,0,1,1,1,0,0,0,
1,0,0,0,1,1,1,1,1,0,0,
1,0,0,1,1,0,0,1,1,1,21,
1,21,21,21,1,0,0,1,1,0,21,
1,21,21,21,1,1,1,1,1,0,21,
1,1,1,1,1,1,1,1,1,1,21,
0,0,0,0,0,0,0,0,0,0,0,
0,0,0,0,0,0,0,0,0,0,0,
0,0,0,0,0,0,0,0,0,0,0,
0,0,0,0,0,0,0,0,0,0,0.
[layer]
type=Tile Layer 2
data=
0,0,0,74,74,0,0,0,74,74,0,
0,0,74,74,0,0,0,0,74,74,0,
0,67,0,0,0,0,67,0,0,0,0,
67,0,0,0,0,67,67,67,0,0,0,
67,0,0,0,67,67,67,67,67,0,0,
67,0,0,67,67,0,0,67,67,67,0,
66,0,0,0,66,0,0,66,66,0,0,
62,0,0,0,62,62,62,62,62,0,0,
47,47,47,47,47,47,47,47,47,47,0,
0,0,0,0,0,0,0,0,0,0,0,
0,0,0,0,0,0,0,0,0,0,0,
0,0,0,0,0,0,0,0,0,0,0,
0,0,0,0,0,0,0,0,0,0,0.