[layer]
type=Tile Layer 1
data=
0,0,1,1,1,1,1,1,1,0,0,
0,1,1,1,0,21,0,1,1,1,0,
0,1,1,1,0,21,0,1,1,1,0,
0,0,5,1,1,1,1,1,6,0,0,
1,3,0,5,1,0,1,6,0,4,1,
0,1,3,21,21,1,21,21,4,1,0,
0,0,1,0,0,0,0,0,1,0,0,
0,0,0,0,0,0,0,0,0,0,0,
0,0,0,0,0,0,0,0,0,0,0,
0,0,0,0,0,0,0,0,0,0,0,
0,0,0,0,0,0,0,0,0,0,0.
[layer]
type=Tile Layer 2
data=
0,0,35,35,35,35,35,35,35,0,0,
0,35,35,35,0,0,0,35,35,35,0,
0,34,34,34,0,0,0,34,34,34,0,
0,0,33,33,33,33,33,33,33,0,0,
30,30,0,30,30,0,30,30,0,30,30,
0,33,33,0,0,33,0,0,33,33,0,
0,0,31,0,0,0,0,0,31,0,0,
0,0,0,0,0,0,0,0,0,0,0,
0,0,0,0,0,0,0,0,0,0,0,
0,0,0,0,0,0,0,0,0,0,0,
0,0,0,0,0,0,0,0,0,0,0.