[layer]
type=Tile Layer 1
data=
0,1,1,1,1,1,1,1,1,0,0,
0,0,21,21,1,1,1,21,21,0,0,
0,21,1,1,1,1,1,1,21,0,0,
21,1,1,1,1,1,1,1,1,0,0,
1,1,1,1,1,1,1,1,1,0,0,
1,1,0,0,0,0,0,0,1,1,0,
1,1,0,0,0,1,1,1,0,1,0,
0,1,0,0,1,0,0,0,0,1,0,
0,1,0,0,1,1,1,0,0,1,0,
0,0,0,0,0,0,0,0,0,0,0,
0,0,0,0,0,0,0,0,0,0,0,
0,0,0,0,0,0,0,0,0,0,0,
0,0,0,0,0,0,0,0,0,0,0.
[layer]
type=Tile Layer 2
data=
0,53,53,53,53,53,53,53,53,0,0,
0,0,0,0,59,59,59,0,0,0,0,
0,0,49,49,49,49,49,49,0,0,0,
0,42,42,42,42,42,42,42,42,0,0,
38,38,38,38,38,38,38,38,38,0,0,
47,47,0,0,0,0,0,0,47,47,0,
47,47,0,0,0,47,47,47,0,47,0,
0,47,0,0,47,0,0,0,0,47,0,
0,47,0,0,47,47,47,0,0,47,0,
0,0,0,0,0,0,0,0,0,0,0,
0,0,0,0,0,0,0,0,0,0,0,
0,0,0,0,0,0,0,0,0,0,0,
0,0,0,0,0,0,0,0,0,0,0.