[layer]
type=Tile Layer 1
data=
1,21,1,0,0,0,0,0,1,0,1,
2,0,2,0,1,1,1,1,1,21,1,
1,0,1,0,0,0,1,1,21,8,0,
1,21,1,1,1,0,1,1,1,0,1,
1,0,0,0,1,0,21,0,1,1,1,
1,1,1,21,1,1,1,0,1,1,1,
0,21,2,0,0,0,1,0,0,0,0,
1,21,1,2,1,0,2,1,1,1,1,
1,0,0,0,1,0,0,0,0,1,1,
1,1,1,8,1,1,1,21,1,1,1,
1,1,0,1,1,1,1,1,1,1,1,
1,0,1,1,1,1,1,0,1,21,1,
1,21,0,0,0,0,1,0,1,0,0,
0,0,0,0,0,0,0,0,0,0,0,
0,0,0,0,0,0,0,0,0,0,0,
0,0,0,0,0,0,0,0,0,0,0,
0,0,0,0,0,0,0,0,0,0,0.
[layer]
type=Tile Layer 2
data=
69,0,69,0,0,0,0,0,69,0,69,
61,0,61,0,61,61,61,61,61,0,61,
99,0,99,0,0,0,99,99,0,0,0,
54,0,54,54,54,0,54,54,54,0,54,
59,0,0,0,59,0,0,0,59,59,59,
46,46,46,0,46,46,46,0,46,46,46,
0,0,51,0,0,0,51,0,0,0,0,
40,0,40,40,40,0,40,40,40,40,40,
49,0,0,0,49,0,0,0,0,49,49,
58,58,58,0,58,58,58,0,58,58,58,
34,34,0,34,34,34,34,34,34,34,34,
43,0,43,43,43,43,43,0,43,0,43,
47,0,0,0,0,0,47,0,47,0,0,
0,0,0,0,0,0,0,0,0,0,0,
0,0,0,0,0,0,0,0,0,0,0,
0,0,0,0,0,0,0,0,0,0,0,
0,0,0,0,0,0,0,0,0,0,0.