[layer]
type=Tile Layer 1
data=
16,1,1,0,0,0,16,1,1,1,1,
1,1,21,0,1,1,1,17,0,17,1,
0,1,0,1,0,1,21,16,16,1,0,
0,1,1,1,1,1,1,1,1,1,1,
1,1,0,0,21,24,0,0,0,0,1,
1,1,0,0,0,0,21,0,0,0,1,
1,1,0,0,0,1,21,1,0,1,1,
0,1,1,17,17,21,1,1,0,1,1,
21,1,16,16,1,1,1,1,0,0,1,
1,1,1,0,1,1,1,1,1,1,1,
1,16,16,0,0,0,0,21,0,0,0,
1,1,7,1,1,0,0,0,0,0,0,
1,0,0,21,0,0,0,0,0,0,0,
0,0,0,0,21,0,0,0,1,1,1,
0,0,0,0,0,0,21,0,1,1,1,
1,0,0,1,0,0,0,0,1,1,21,
1,0,0,0,0,0,21,1,1,1,0,
1,1,1,0,0,21,1,1,1,1,1,
1,21,1,1,0,0,1,1,0,0,1,
0,0,0,0,0,0,0,0,0,0,0,
0,0,0,0,0,0,0,0,0,0,0,
0,0,0,0,0,0,0,0,0,0,0,
0,0,0,0,0,0,0,0,0,0,0.
[layer]
type=Tile Layer 2
data=
38,77,77,0,0,0,38,77,77,77,77,
77,77,0,0,77,77,77,38,0,38,77,
0,85,0,85,0,85,0,42,42,85,0,
0,65,65,65,65,65,65,65,65,65,65,
136,136,0,0,0,0,0,0,0,0,136,
90,90,0,0,0,0,0,0,0,0,90,
82,82,0,0,0,82,0,82,0,82,82,
0,73,73,36,36,0,73,73,0,73,73,
0,72,36,36,72,72,72,72,0,0,72,
51,51,51,0,51,51,51,51,51,51,51,
72,36,36,0,0,0,0,0,0,0,0,
106,106,0,106,106,0,0,0,0,0,0,
64,0,0,0,0,0,0,0,0,0,0,
0,0,0,0,0,0,0,0,63,63,63,
0,0,0,0,0,0,0,0,62,62,62,
61,0,0,61,0,0,0,0,61,61,0,
60,0,0,0,0,0,0,60,60,60,0,
53,53,53,0,0,0,53,53,53,53,53,
58,0,58,58,0,0,58,58,0,0,58,
0,0,0,0,0,0,0,0,0,0,0,
0,0,0,0,0,0,0,0,0,0,0,
0,0,0,0,0,0,0,0,0,0,0,
0,0,0,0,0,0,0,0,0,0,0.