[layer]
type=Tile Layer 1
data=
1,6,1,4,1,0,0,0,21,1,1,
1,2,5,0,2,0,0,21,0,1,1,
6,3,2,1,0,0,0,0,21,2,1,
5,2,1,2,0,0,0,0,0,21,1,
4,1,1,1,0,0,21,0,0,0,0,
0,21,0,0,1,1,1,3,6,1,0,
5,8,0,0,0,1,0,2,1,4,1,
3,1,0,0,0,0,0,1,0,0,21,
1,4,0,21,0,0,1,1,0,0,0,
0,1,7,0,0,0,3,1,0,0,1,
3,4,1,21,0,0,1,1,0,0,1,
3,2,1,0,0,0,0,2,0,0,21,
1,1,5,5,0,1,1,1,3,1,1,
4,1,0,0,0,21,0,0,0,0,1,
1,0,1,5,0,0,0,21,0,0,1,
4,0,0,1,1,0,0,21,0,0,1,
0,4,1,6,1,1,1,1,1,3,1,
0,0,0,0,0,0,0,0,0,0,0,
0,0,0,0,0,0,0,0,0,0,0,
0,0,0,0,0,0,0,0,0,0,0,
0,0,0,0,0,0,0,0,0,0,0.
[layer]
type=Tile Layer 2
data=
73,73,73,73,73,0,0,0,0,73,73,
78,78,78,0,78,0,0,0,0,78,78,
77,77,77,77,0,0,0,0,0,77,77,
76,76,76,76,0,0,0,0,0,0,76,
68,68,68,68,0,0,0,0,0,0,0,
0,0,0,0,67,67,67,67,67,67,0,
99,0,0,0,0,99,0,99,99,99,99,
61,61,0,0,0,0,0,61,0,0,0,
60,60,0,0,0,0,60,60,0,0,0,
0,88,0,0,0,0,88,88,0,0,88,
53,53,53,0,0,0,53,53,0,0,53,
52,52,52,0,0,0,0,52,0,0,0,
37,37,37,37,0,37,37,37,37,37,37,
51,51,0,0,0,0,0,0,0,0,51,
50,0,50,50,0,0,0,0,0,0,50,
49,0,0,49,49,0,0,0,0,0,49,
0,35,35,35,35,35,35,35,35,35,35,
0,0,0,0,0,0,0,0,0,0,0,
0,0,0,0,0,0,0,0,0,0,0,
0,0,0,0,0,0,0,0,0,0,0,
0,0,0,0,0,0,0,0,0,0,0.