[layer]
type=Tile Layer 1
data=
0,0,2,6,0,2,21,5,2,0,0,
9,0,6,0,1,1,1,21,5,0,9,
9,0,7,5,0,2,0,6,21,0,9,
0,0,0,3,0,0,0,4,0,0,0,
0,0,3,0,2,2,2,21,4,0,0,
0,0,0,0,0,21,1,0,7,0,0,
0,0,1,0,1,0,0,0,1,0,0,
9,0,6,21,1,1,1,0,5,0,9,
9,9,0,0,0,0,0,0,0,20,9,
0,20,0,0,0,0,0,0,0,9,0,
0,11,0,0,0,0,0,0,0,11,0,
0,0,0,0,0,0,0,0,0,0,0,
0,0,0,0,0,0,0,0,0,0,0.
[layer]
type=Tile Layer 2
data=
0,0,45,45,0,45,0,45,45,0,0,
45,0,45,0,45,45,45,0,45,0,45,
39,0,0,58,0,58,0,58,0,0,39,
0,0,0,38,0,0,0,38,0,0,0,
0,0,38,0,38,38,38,0,38,0,0,
0,0,0,0,0,0,55,0,0,0,0,
0,0,37,0,37,0,0,0,37,0,0,
37,0,37,0,37,37,37,0,37,0,37,
37,37,0,0,0,0,0,0,0,0,37,
0,0,0,0,0,0,0,0,0,37,0,
0,37,0,0,0,0,0,0,0,37,0,
0,0,0,0,0,0,0,0,0,0,0,
0,0,0,0,0,0,0,0,0,0,0.