[layer]
type=Tile Layer 1
data=
5,0,2,2,0,0,0,0,0,21,0,
1,21,4,1,3,1,3,1,1,0,1,
0,0,1,21,0,0,0,0,1,6,1,
2,6,2,21,1,1,1,24,5,1,1,
1,0,0,0,1,6,0,0,0,0,21,
4,21,1,1,1,3,1,5,1,1,1,
1,0,0,0,5,0,0,0,1,1,21,
1,1,1,0,1,21,6,7,1,4,1,
1,0,1,1,1,3,1,6,5,1,1,
0,0,0,0,0,0,0,0,0,0,0,
0,0,0,0,0,0,0,0,0,0,0,
0,0,0,0,0,0,0,0,0,0,0,
0,0,0,0,0,0,0,0,0,0,0.
[layer]
type=Tile Layer 2
data=
47,0,47,47,0,0,0,0,0,0,0,
37,0,37,37,37,37,37,37,37,0,37,
0,0,40,0,0,0,0,0,40,40,40,
48,48,48,0,48,48,48,0,48,48,48,
39,0,0,0,39,39,0,0,0,0,0,
27,0,27,27,27,27,27,27,27,27,27,
37,0,0,0,37,0,0,0,37,37,0,
49,49,49,0,49,0,49,0,49,49,49,
26,0,26,26,26,26,26,26,26,26,26,
0,0,0,0,0,0,0,0,0,0,0,
0,0,0,0,0,0,0,0,0,0,0,
0,0,0,0,0,0,0,0,0,0,0,
0,0,0,0,0,0,0,0,0,0,0.