[layer]
type=Tile Layer 1
data=
0,0,0,0,3,0,1,21,0,0,0,
6,1,1,0,1,21,1,1,3,6,1,
1,0,0,0,1,0,0,0,4,0,21,
5,1,1,1,0,6,1,5,1,1,1,
6,0,1,1,0,21,0,0,0,7,1,
1,21,6,1,4,1,1,1,1,5,1,
1,0,0,0,6,0,0,0,1,0,0,
1,3,1,21,4,0,1,0,1,0,1,
0,0,1,0,0,21,4,0,1,0,0,
1,21,1,1,6,1,3,0,1,3,1,
6,0,1,21,0,0,0,0,0,0,0,
0,0,0,0,0,0,0,0,0,0,0,
0,0,0,0,0,0,0,0,0,0,0,
0,0,0,0,0,0,0,0,0,0,0,
0,0,0,0,0,0,0,0,0,0,0.
[layer]
type=Tile Layer 2
data=
0,0,0,0,62,0,62,0,0,0,0,
45,45,45,0,45,0,45,45,45,45,45,
55,0,0,0,55,0,0,0,55,0,0,
38,38,38,38,0,38,38,38,38,38,38,
72,0,72,72,0,0,0,0,0,0,72,
33,0,33,33,33,33,33,33,33,33,33,
46,0,0,0,46,0,0,0,46,0,0,
46,46,46,0,46,0,46,0,46,0,46,
0,0,46,0,0,0,46,0,46,0,0,
36,0,36,36,36,36,36,0,36,36,36,
44,0,44,0,0,0,0,0,0,0,0,
0,0,0,0,0,0,0,0,0,0,0,
0,0,0,0,0,0,0,0,0,0,0,
0,0,0,0,0,0,0,0,0,0,0,
0,0,0,0,0,0,0,0,0,0,0.