[layer]
type=Tile Layer 1
data=
0,0,0,1,0,1,0,4,3,0,4,
0,1,0,1,0,1,0,1,1,0,1,
0,1,1,1,1,1,0,1,1,1,1,
0,1,9,1,0,1,1,1,1,1,1,
0,1,1,1,1,1,1,9,1,1,1,
0,0,0,1,0,1,1,1,9,1,1,
0,1,1,1,1,0,1,1,1,1,0,
0,0,1,1,1,1,1,1,0,0,0,
0,0,0,0,0,0,0,0,0,0,0,
0,0,0,0,0,0,0,0,0,0,0,
0,0,0,0,0,0,0,0,0,0,0.
[layer]
type=Tile Layer 2
data=
0,0,0,60,0,60,0,42,42,0,60,
0,48,0,48,0,48,0,33,33,0,48,
0,37,27,27,27,37,0,37,27,27,37,
0,37,27,37,0,37,27,27,27,27,37,
0,42,30,30,30,30,30,30,30,30,42,
0,0,0,60,0,42,30,30,30,30,42,
0,42,30,30,42,0,42,30,30,42,0,
0,0,60,60,60,60,60,60,0,0,0,
0,0,0,0,0,0,0,0,0,0,0,
0,0,0,0,0,0,0,0,0,0,0,
0,0,0,0,0,0,0,0,0,0,0.