[layer]
type=Tile Layer 1
data=
1,1,0,1,1,1,1,1,1,1,1,
1,1,0,1,1,1,0,21,1,1,1,
1,1,21,0,1,1,1,0,0,0,0,
1,1,1,1,1,0,1,1,1,1,1,
1,7,21,0,0,1,1,1,1,0,0,
1,8,21,1,1,1,1,1,1,0,0,
1,1,21,1,1,1,1,1,1,7,0,
1,1,0,1,1,1,1,1,0,0,0,
1,1,0,0,1,1,1,1,21,1,1,
0,21,0,0,1,1,1,0,0,1,1,
0,0,1,1,1,1,1,0,0,1,1,
0,0,0,0,0,0,0,0,0,0,0,
0,0,0,0,0,0,0,0,0,0,0,
0,0,0,0,0,0,0,0,0,0,0,
0,0,0,0,0,0,0,0,0,0,0.
[layer]
type=Tile Layer 2
data=
39,39,0,39,39,39,39,39,39,39,39,
47,47,0,47,47,47,0,0,47,47,47,
51,51,0,0,51,51,51,0,0,0,0,
35,35,35,35,35,0,35,35,35,35,35,
67,0,0,0,0,67,67,67,67,0,0,
66,0,0,66,66,66,66,66,66,0,0,
57,57,0,57,57,57,57,57,57,0,0,
42,42,0,42,42,42,42,42,0,0,0,
38,38,0,0,38,38,38,38,0,38,38,
0,0,0,0,41,41,41,0,0,41,41,
0,0,41,41,41,41,41,0,0,41,41,
0,0,0,0,0,0,0,0,0,0,0,
0,0,0,0,0,0,0,0,0,0,0,
0,0,0,0,0,0,0,0,0,0,0,
0,0,0,0,0,0,0,0,0,0,0.