[layer]
type=Tile Layer 1
data=
0,0,1,0,21,0,1,0,0,0,0,
1,21,1,0,1,1,1,1,1,1,1,
1,0,0,0,1,1,21,0,0,8,0,
2,1,1,1,1,2,1,0,2,21,1,
1,2,1,2,1,1,0,1,2,1,1,
1,0,1,21,1,0,1,1,1,1,1,
0,21,1,0,24,0,1,0,0,0,0,
1,1,1,1,1,1,1,21,1,1,1,
0,0,0,0,21,0,1,0,2,1,0,
1,1,1,1,1,0,1,0,1,1,1,
0,0,0,0,1,21,0,0,1,0,0,
1,1,1,0,1,1,1,1,1,0,1,
1,0,0,8,1,0,21,0,0,0,1,
1,1,1,1,1,1,1,0,1,1,1,
1,0,1,1,0,0,1,0,0,21,0,
0,0,0,0,0,0,0,0,0,0,0,
0,0,0,0,0,0,0,0,0,0,0,
0,0,0,0,0,0,0,0,0,0,0,
0,0,0,0,0,0,0,0,0,0,0.
[layer]
type=Tile Layer 2
data=
0,0,76,0,0,0,76,0,0,0,0,
60,0,60,0,60,60,60,60,60,60,60,
100,0,0,0,100,100,0,0,0,0,0,
53,53,53,53,53,53,53,0,53,0,53,
45,45,45,45,45,45,0,45,45,45,45,
54,0,54,0,54,0,54,54,54,54,54,
0,0,88,0,0,0,88,0,0,0,0,
41,41,41,41,41,41,41,0,41,41,41,
0,0,0,0,0,0,51,0,51,51,0,
40,40,40,40,40,0,40,0,40,40,40,
0,0,0,0,50,0,0,0,50,0,0,
39,39,39,0,39,39,39,39,39,0,39,
73,0,0,0,73,0,0,0,0,0,73,
34,34,34,34,34,34,34,0,34,34,34,
48,0,48,48,0,0,48,0,0,0,0,
0,0,0,0,0,0,0,0,0,0,0,
0,0,0,0,0,0,0,0,0,0,0,
0,0,0,0,0,0,0,0,0,0,0,
0,0,0,0,0,0,0,0,0,0,0.