[layer]
type=Tile Layer 1
data=
21,16,16,1,1,1,1,1,1,1,24,
21,0,0,0,0,0,0,0,0,1,0,
0,1,1,1,1,1,1,1,1,1,21,
0,17,0,0,0,0,0,0,0,0,21,
21,1,1,1,1,1,1,1,1,1,0,
21,0,0,0,0,0,0,0,0,1,0,
0,1,1,1,1,1,1,1,1,1,21,
0,1,0,0,0,0,0,0,0,0,0,
24,1,1,1,1,1,1,1,1,1,21,
0,0,0,0,0,0,0,0,0,0,0,
0,0,0,0,0,0,0,0,0,0,0,
0,0,0,0,0,0,0,0,0,0,0,
0,0,0,0,0,0,0,0,0,0,0.
[layer]
type=Tile Layer 2
data=
0,36,36,72,72,72,72,72,72,72,0,
0,0,0,0,0,0,0,0,0,59,0,
0,41,41,41,41,41,41,41,41,41,0,
0,25,0,0,0,0,0,0,0,0,0,
0,40,40,40,40,40,40,40,40,40,0,
0,0,0,0,0,0,0,0,0,49,0,
0,38,38,38,38,38,38,38,38,38,0,
0,47,0,0,0,0,0,0,0,0,0,
0,57,57,57,57,57,57,57,57,57,0,
0,0,0,0,0,0,0,0,0,0,0,
0,0,0,0,0,0,0,0,0,0,0,
0,0,0,0,0,0,0,0,0,0,0,
0,0,0,0,0,0,0,0,0,0,0.