[layer]
type=Tile Layer 1
data=
1,1,1,21,0,0,21,1,0,0,1,
1,17,21,7,0,21,1,0,0,17,1,
1,1,21,0,21,1,1,0,0,1,1,
1,21,0,0,1,1,1,0,0,17,1,
21,0,0,0,0,0,8,0,0,0,1,
21,0,1,1,1,1,1,1,0,0,1,
0,0,1,1,1,1,1,1,1,0,0,
0,0,1,1,1,1,17,1,1,0,0,
0,0,1,1,1,1,1,1,1,0,1,
0,0,0,0,0,0,0,0,0,0,0,
0,0,0,0,0,0,0,0,0,0,0,
0,0,0,0,0,0,0,0,0,0,0,
0,0,0,0,0,0,0,0,0,0,0.
[layer]
type=Tile Layer 2
data=
84,84,84,0,0,0,0,84,0,0,84,
123,61,0,0,0,0,123,0,0,61,123,
72,72,0,0,0,72,72,0,0,72,72,
70,0,0,0,70,70,70,0,0,35,70,
0,0,0,0,0,0,0,0,0,0,103,
0,0,68,68,68,68,68,68,0,0,68,
0,0,68,68,68,68,68,68,68,0,0,
0,0,68,68,68,68,34,68,68,0,0,
0,0,68,68,68,68,68,68,68,0,68,
0,0,0,0,0,0,0,0,0,0,0,
0,0,0,0,0,0,0,0,0,0,0,
0,0,0,0,0,0,0,0,0,0,0,
0,0,0,0,0,0,0,0,0,0,0.