[layer]
type=Tile Layer 1
data=
1,1,1,1,1,1,1,1,0,1,1,
1,1,1,1,0,1,1,1,1,0,21,
1,1,1,1,21,1,1,1,1,1,0,
0,0,21,0,0,1,1,1,1,1,0,
0,0,0,1,1,1,1,1,1,1,21,
21,0,0,1,1,1,1,1,1,0,0,
21,1,1,1,1,1,1,1,1,0,0,
0,1,1,1,1,1,1,1,0,0,0,
0,0,0,21,1,1,1,1,0,0,1,
1,1,1,1,1,1,1,1,0,1,1,
1,1,1,1,0,1,1,1,1,0,21,
1,1,1,1,1,1,1,0,1,1,1,
0,1,1,1,1,1,1,1,0,0,0,
0,21,1,1,1,1,1,1,0,0,1,
1,0,1,1,1,1,1,1,1,0,21,
0,0,0,0,0,0,0,0,0,0,0,
0,0,0,0,0,0,0,0,0,0,0,
0,0,0,0,0,0,0,0,0,0,0,
0,0,0,0,0,0,0,0,0,0,0.
[layer]
type=Tile Layer 2
data=
53,53,53,53,53,53,53,53,0,53,53,
67,67,67,67,0,67,67,67,67,0,0,
54,54,54,54,0,54,54,54,54,54,0,
0,0,0,0,0,66,66,66,66,66,0,
0,0,0,65,65,65,65,65,65,65,0,
0,0,0,59,59,59,59,59,59,0,0,
0,52,52,52,52,52,52,52,52,0,0,
0,57,57,57,57,57,57,57,0,0,0,
0,0,0,0,51,51,51,51,0,0,51,
36,36,36,36,36,36,36,36,0,36,36,
45,45,45,45,0,45,45,45,45,0,0,
35,35,35,35,35,35,35,0,35,35,35,
0,49,49,49,49,49,49,49,0,0,0,
0,0,49,49,49,49,49,49,0,0,49,
43,0,43,43,43,43,43,43,43,0,0,
0,0,0,0,0,0,0,0,0,0,0,
0,0,0,0,0,0,0,0,0,0,0,
0,0,0,0,0,0,0,0,0,0,0,
0,0,0,0,0,0,0,0,0,0,0.