[layer]
type=Tile Layer 1
data=
0,0,1,1,0,0,0,1,2,0,0,
0,1,0,0,1,1,1,0,0,1,0,
21,1,0,0,0,0,0,0,24,2,21,
21,1,0,1,0,0,0,1,0,1,21,
21,1,0,0,0,1,0,0,0,2,21,
0,1,0,1,1,1,1,1,0,1,0,
0,0,1,1,1,1,1,1,1,0,0,
0,21,21,1,1,1,1,1,21,21,0,
0,1,1,0,1,1,1,0,1,1,0,
0,0,0,0,0,0,0,0,0,0,0,
0,0,0,0,0,0,0,0,0,0,0,
0,0,0,0,0,0,0,0,0,0,0,
0,0,0,0,0,0,0,0,0,0,0.
[layer]
type=Tile Layer 2
data=
0,0,74,74,0,0,0,74,74,0,0,
0,74,0,0,74,74,74,0,0,74,0,
0,100,0,0,0,0,0,0,0,100,0,
0,65,0,65,0,0,0,65,0,65,0,
0,63,0,0,0,63,0,0,0,63,0,
0,61,0,61,61,61,61,61,0,61,0,
0,0,61,61,61,61,61,61,61,0,0,
0,0,0,61,61,61,61,61,0,0,0,
0,58,58,0,58,58,58,0,58,58,0,
0,0,0,0,0,0,0,0,0,0,0,
0,0,0,0,0,0,0,0,0,0,0,
0,0,0,0,0,0,0,0,0,0,0,
0,0,0,0,0,0,0,0,0,0,0.