[layer]
type=Tile Layer 1
data=
0,0,16,1,1,0,0,0,24,0,0,
0,0,1,21,21,1,0,0,1,1,1,
1,0,0,1,21,21,1,1,0,0,0,
0,1,0,17,1,1,21,1,0,0,0,
0,1,1,0,1,1,1,0,1,1,0,
0,1,1,0,17,1,1,0,1,1,0,
0,1,0,1,1,1,21,1,0,0,0,
1,0,0,1,21,21,1,1,0,0,0,
0,0,1,21,21,1,0,0,1,1,1,
0,0,0,0,0,0,0,0,0,0,0,
0,0,0,0,0,0,0,0,0,0,0,
0,0,0,0,0,0,0,0,0,0,0,
0,0,0,0,0,0,0,0,0,0,0.
[layer]
type=Tile Layer 2
data=
0,0,54,109,109,0,0,0,0,0,0,
0,0,73,0,0,73,0,0,73,73,73,
64,0,0,64,0,0,64,64,0,0,0,
0,62,0,31,62,62,0,62,0,0,0,
0,61,61,0,61,61,61,0,61,61,0,
0,61,61,0,30,61,61,0,61,61,0,
0,61,0,61,61,61,0,61,0,0,0,
60,0,0,60,0,0,60,60,0,0,0,
0,0,58,0,0,58,0,0,58,58,58,
0,0,0,0,0,0,0,0,0,0,0,
0,0,0,0,0,0,0,0,0,0,0,
0,0,0,0,0,0,0,0,0,0,0,
0,0,0,0,0,0,0,0,0,0,0.