[layer]
type=Tile Layer 1
data=
1,1,0,1,1,1,1,1,21,1,1,
1,1,21,1,1,1,1,1,1,1,1,
1,1,1,1,1,1,0,1,1,1,1,
0,1,1,1,21,1,1,1,0,1,0,
0,0,0,1,0,0,0,0,0,1,0,
1,1,0,1,1,1,1,1,21,1,1,
0,0,0,1,0,21,0,1,0,0,0,
1,1,1,1,0,1,0,1,1,1,21,
0,0,0,1,1,1,21,0,0,1,0,
0,1,0,1,1,1,1,1,0,1,0,
0,1,0,21,0,0,0,1,0,0,0,
0,1,1,1,1,1,0,1,1,1,21,
0,0,0,1,1,1,0,21,0,1,0,
1,1,21,1,0,1,1,1,0,1,1,
0,0,0,1,0,0,0,1,0,21,0,
1,1,1,1,1,1,0,1,1,1,1,
0,1,0,0,0,1,0,0,0,0,21,
0,0,0,0,0,0,0,0,0,0,0,
0,0,0,0,0,0,0,0,0,0,0,
0,0,0,0,0,0,0,0,0,0,0,
0,0,0,0,0,0,0,0,0,0,0.
[layer]
type=Tile Layer 2
data=
74,74,0,74,74,74,74,74,0,74,74,
71,71,0,71,71,71,71,71,71,71,71,
70,70,70,70,70,70,0,70,70,70,70,
0,88,88,88,0,88,88,88,0,88,0,
0,0,0,80,0,0,0,0,0,80,0,
72,72,0,72,72,72,72,72,0,72,72,
0,0,0,78,0,0,0,78,0,0,0,
71,71,71,71,0,71,0,71,71,71,0,
0,0,0,70,70,70,0,0,0,70,0,
0,69,0,69,69,69,69,69,0,69,0,
0,62,0,0,0,0,0,62,0,0,0,
0,61,61,61,61,61,0,61,61,61,0,
0,0,0,60,60,60,0,0,0,60,0,
59,59,0,59,0,59,59,59,0,59,59,
0,0,0,58,0,0,0,58,0,0,0,
46,46,46,46,46,46,0,46,46,46,46,
0,57,0,0,0,57,0,0,0,0,0,
0,0,0,0,0,0,0,0,0,0,0,
0,0,0,0,0,0,0,0,0,0,0,
0,0,0,0,0,0,0,0,0,0,0,
0,0,0,0,0,0,0,0,0,0,0.