[layer]
type=Tile Layer 1
data=
1,21,1,1,1,1,1,1,1,1,1,
1,0,1,1,1,1,1,0,21,0,0,
1,0,1,1,1,1,1,0,0,21,1,
1,1,1,1,1,0,0,0,0,0,1,
1,1,1,1,1,0,1,1,1,1,1,
1,1,1,0,0,21,0,0,0,0,1,
1,1,1,0,21,0,0,0,0,0,1,
21,0,1,1,1,1,1,1,1,1,1,
0,0,21,0,0,1,1,1,1,1,1,
0,0,0,21,0,1,1,1,1,1,1,
0,0,0,21,0,1,0,1,1,1,1,
0,0,0,0,0,0,0,0,0,0,0,
0,0,0,0,0,0,0,0,0,0,0,
0,0,0,0,0,0,0,0,0,0,0,
0,0,0,0,0,0,0,0,0,0,0.
[layer]
type=Tile Layer 2
data=
43,0,43,43,43,43,43,43,43,43,43,
56,0,56,56,56,56,56,0,0,0,0,
55,0,55,55,55,55,55,0,0,0,55,
54,54,54,54,54,0,0,0,0,0,54,
34,34,34,34,34,0,34,34,34,34,34,
48,48,48,0,0,0,0,0,0,0,48,
47,47,47,0,0,0,0,0,0,0,47,
0,0,37,37,37,37,37,37,37,37,37,
0,0,0,0,0,46,46,46,46,46,46,
0,0,0,0,0,45,45,45,45,45,45,
0,0,0,0,0,44,0,44,44,44,44,
0,0,0,0,0,0,0,0,0,0,0,
0,0,0,0,0,0,0,0,0,0,0,
0,0,0,0,0,0,0,0,0,0,0,
0,0,0,0,0,0,0,0,0,0,0.