[layer]
type=Tile Layer 1
data=
0,1,1,1,0,0,0,1,1,1,0,
0,0,21,1,1,1,1,1,21,0,0,
0,21,0,0,1,1,1,0,0,21,0,
21,1,1,1,1,1,1,1,1,1,21,
0,21,1,1,1,1,1,1,1,21,0,
0,0,21,1,0,1,0,1,21,0,0,
0,0,1,0,0,1,0,0,1,0,0,
0,1,1,0,0,0,0,0,1,1,0,
0,1,1,0,0,1,0,0,1,1,0,
0,0,0,0,0,0,0,0,0,0,0,
0,0,0,0,0,0,0,0,0,0,0,
0,0,0,0,0,0,0,0,0,0,0,
0,0,0,0,0,0,0,0,0,0,0.
[layer]
type=Tile Layer 2
data=
0,75,75,75,0,0,0,75,75,75,0,
0,0,0,75,75,75,75,75,0,0,0,
0,0,0,0,66,66,66,0,0,0,0,
0,58,58,58,58,58,58,58,58,58,0,
0,0,62,62,62,62,62,62,62,0,0,
0,0,0,60,0,60,0,60,0,0,0,
0,0,59,0,0,59,0,0,59,0,0,
0,59,59,0,0,0,0,0,59,59,0,
0,59,59,0,0,59,0,0,59,59,0,
0,0,0,0,0,0,0,0,0,0,0,
0,0,0,0,0,0,0,0,0,0,0,
0,0,0,0,0,0,0,0,0,0,0,
0,0,0,0,0,0,0,0,0,0,0.