[layer]
type=Tile Layer 1
data=
0,0,1,1,1,1,1,1,1,0,0,
0,0,1,1,17,1,1,1,1,0,0,
0,0,7,1,1,1,1,1,0,0,0,
0,0,0,1,1,17,1,1,0,0,0,
0,0,1,22,22,1,1,1,1,0,0,
0,1,22,22,1,1,1,1,1,1,0,
7,1,22,1,1,1,1,1,1,1,0,
0,0,1,1,1,1,1,1,1,0,0,
0,0,0,0,0,0,0,0,0,0,0,
0,0,0,0,0,0,0,0,0,0,0,
0,0,0,0,0,0,0,0,0,0,0,
0,0,0,0,0,0,0,0,0,0,0,
0,0,0,0,0,0,0,0,0,0,0.
[layer]
type=Tile Layer 2
data=
0,0,53,53,53,53,53,53,53,0,0,
0,0,53,53,26,53,53,53,53,0,0,
0,0,0,70,70,70,70,70,0,0,0,
0,0,0,47,47,23,47,47,0,0,0,
0,0,47,0,0,47,47,47,47,0,0,
0,46,0,0,46,46,46,46,46,46,0,
0,58,0,58,58,58,58,58,58,58,0,
0,0,43,43,43,43,43,43,43,0,0,
0,0,0,0,0,0,0,0,0,0,0,
0,0,0,0,0,0,0,0,0,0,0,
0,0,0,0,0,0,0,0,0,0,0,
0,0,0,0,0,0,0,0,0,0,0,
0,0,0,0,0,0,0,0,0,0,0.