[layer]
type=Tile Layer 1
data=
0,0,0,0,0,1,0,0,0,0,0,
0,0,0,21,1,1,1,21,0,0,0,
7,0,21,1,1,1,1,16,21,0,0,
0,0,0,21,1,1,1,21,0,0,0,
0,0,1,1,21,1,21,16,1,0,0,
0,1,1,1,1,1,1,1,1,1,0,
0,1,1,16,1,16,1,1,1,1,0,
0,1,1,1,1,1,1,1,1,1,0,
0,0,1,1,21,1,21,1,1,0,0,
0,0,0,0,0,0,0,0,0,0,0,
0,0,0,0,0,0,0,0,0,0,0,
0,0,0,0,0,0,0,0,0,0,0,
0,0,0,0,0,0,0,0,0,0,0.
[layer]
type=Tile Layer 2
data=
0,0,0,0,0,75,0,0,0,0,0,
0,0,0,0,75,75,75,0,0,0,0,
0,0,0,99,99,99,99,49,0,0,0,
0,0,0,0,64,64,64,0,0,0,0,
0,0,62,62,0,62,0,31,62,0,0,
0,54,54,54,54,54,54,54,54,54,0,
0,54,54,27,54,27,54,54,54,54,0,
0,54,54,54,54,54,54,54,54,54,0,
0,0,60,60,0,60,0,60,60,0,0,
0,0,0,0,0,0,0,0,0,0,0,
0,0,0,0,0,0,0,0,0,0,0,
0,0,0,0,0,0,0,0,0,0,0,
0,0,0,0,0,0,0,0,0,0,0.