[layer]
type=Tile Layer 1
data=
0,1,1,1,0,0,21,0,1,0,0,
21,7,1,2,1,1,1,1,1,1,0,
0,0,0,0,1,1,1,1,1,1,0,
7,21,0,0,0,1,1,1,0,1,1,
0,1,1,1,1,1,1,1,1,1,1,
0,2,0,1,21,1,0,0,0,1,0,
0,21,1,1,1,0,0,0,0,0,0,
21,1,1,1,1,1,0,0,0,0,1,
21,0,1,1,1,0,0,0,0,0,0,
0,1,1,0,0,1,0,0,0,21,0,
1,1,1,0,0,0,21,0,0,0,0,
0,0,0,0,0,0,0,0,0,0,0,
0,0,0,0,0,0,0,0,0,0,0,
0,0,0,0,0,0,0,0,0,0,0,
0,0,0,0,0,0,0,0,0,0,0.
[layer]
type=Tile Layer 2
data=
0,59,59,59,0,0,0,0,59,0,0,
0,0,70,70,70,70,70,70,70,70,0,
0,0,0,0,52,52,52,52,52,52,0,
0,0,0,0,0,78,78,78,0,78,78,
0,32,32,32,32,32,32,32,32,32,32,
0,46,0,46,0,46,0,0,0,46,0,
0,0,45,45,45,0,0,0,0,0,0,
0,44,44,44,44,44,0,0,0,0,44,
0,0,43,43,43,0,0,0,0,0,0,
0,42,42,0,0,42,0,0,0,0,0,
41,41,41,0,0,0,0,0,0,0,0,
0,0,0,0,0,0,0,0,0,0,0,
0,0,0,0,0,0,0,0,0,0,0,
0,0,0,0,0,0,0,0,0,0,0,
0,0,0,0,0,0,0,0,0,0,0.