[layer]
type=Tile Layer 1
data=
0,1,21,0,0,0,0,2,2,1,1,
0,1,0,0,0,7,21,1,2,2,1,
1,1,1,1,1,1,1,1,8,0,21,
2,1,2,1,0,0,0,0,21,2,1,
1,1,1,1,0,21,24,0,0,1,1,
2,2,1,1,0,0,21,0,0,2,1,
0,0,0,0,0,1,1,1,1,1,1,
0,0,0,21,0,1,1,1,0,1,1,
1,1,1,0,1,1,1,1,1,1,1,
21,7,0,0,0,1,0,1,2,1,1,
1,1,1,1,21,1,1,1,8,1,1,
0,0,0,1,21,0,0,1,0,1,1,
7,1,1,1,1,1,7,1,21,1,1,
21,1,1,1,1,1,0,1,0,1,1,
0,1,1,1,1,1,21,1,0,1,1,
1,1,1,2,2,0,1,2,1,1,1,
1,1,1,1,21,1,1,1,8,0,0,
0,1,0,1,0,1,1,1,0,0,21,
8,1,0,1,0,1,1,1,21,1,1,
0,0,0,0,0,0,0,0,0,0,0,
0,0,0,0,0,0,0,0,0,0,0,
0,0,0,0,0,0,0,0,0,0,0,
0,0,0,0,0,0,0,0,0,0,0.
[layer]
type=Tile Layer 2
data=
0,87,0,0,0,0,0,87,87,87,87,
0,129,0,0,0,0,0,129,129,129,129,
114,114,114,114,114,114,114,114,0,0,0,
91,91,91,91,0,0,0,0,0,91,91,
135,135,135,135,0,0,0,0,0,135,135,
89,89,89,89,0,0,0,0,0,89,89,
0,0,0,0,0,81,81,81,81,81,81,
0,0,0,0,0,81,81,81,0,81,81,
56,56,56,0,56,56,56,56,56,56,56,
0,0,0,0,0,109,0,109,109,109,109,
87,87,87,87,0,87,87,87,0,87,87,
0,0,0,71,0,0,0,71,0,71,71,
0,114,114,114,114,114,0,114,0,114,114,
0,56,56,56,56,56,0,56,0,56,56,
0,55,55,55,55,55,0,55,0,55,55,
43,43,43,43,43,0,43,43,43,43,43,
90,90,90,90,0,90,90,90,0,0,0,
0,59,0,59,0,59,59,59,0,0,0,
0,87,0,87,0,87,87,87,0,87,87,
0,0,0,0,0,0,0,0,0,0,0,
0,0,0,0,0,0,0,0,0,0,0,
0,0,0,0,0,0,0,0,0,0,0,
0,0,0,0,0,0,0,0,0,0,0.