[layer]
type=Tile Layer 1
data=
0,3,1,0,0,0,0,0,0,1,0,
4,6,1,6,1,1,1,0,1,1,1,
1,21,1,1,0,0,5,0,0,0,0,
0,0,0,1,6,1,21,1,4,0,0,
0,0,1,3,1,1,21,6,0,0,1,
0,21,6,6,0,0,1,0,0,1,1,
4,1,5,1,0,0,0,0,21,0,1,
1,1,1,4,21,0,4,1,0,1,0,
1,21,1,0,0,1,5,1,3,1,1,
0,1,0,0,21,0,1,0,0,4,1,
1,0,0,0,21,0,0,4,1,1,0,
1,6,0,0,0,0,21,1,5,1,1,
5,0,0,0,0,0,0,0,1,0,21,
0,0,0,0,0,0,0,0,0,0,0,
0,0,0,0,0,0,0,0,0,0,0,
0,0,0,0,0,0,0,0,0,0,0,
0,0,0,0,0,0,0,0,0,0,0.
[layer]
type=Tile Layer 2
data=
0,69,69,0,0,0,0,0,0,69,0,
48,48,48,48,48,48,48,0,48,48,48,
69,0,69,69,0,0,69,0,0,0,0,
0,0,0,62,62,62,0,62,62,0,0,
0,0,61,61,61,61,0,61,0,0,61,
0,0,60,60,0,0,60,0,0,60,60,
53,53,53,53,0,0,0,0,0,0,53,
52,52,52,52,0,0,52,52,0,52,0,
46,0,46,0,0,46,46,46,46,46,46,
0,50,0,0,0,0,50,0,0,50,50,
49,0,0,0,0,0,0,49,49,49,0,
48,48,0,0,0,0,0,48,48,48,48,
47,0,0,0,0,0,0,0,47,0,0,
0,0,0,0,0,0,0,0,0,0,0,
0,0,0,0,0,0,0,0,0,0,0,
0,0,0,0,0,0,0,0,0,0,0,
0,0,0,0,0,0,0,0,0,0,0.