[layer]
type=Tile Layer 1
data=
1,16,16,1,5,1,0,0,8,0,21,
0,1,6,1,1,3,0,0,0,0,21,
0,1,1,5,3,1,0,21,0,0,0,
1,1,1,0,1,3,1,1,17,17,1,
21,6,1,1,5,1,0,0,0,0,0,
24,1,1,1,3,5,0,0,7,0,21,
6,1,21,1,1,5,0,0,0,0,0,
0,6,0,1,1,1,0,0,0,21,0,
0,16,0,1,4,1,7,0,0,0,21,
1,6,1,1,0,0,0,21,0,0,0,
21,0,0,0,1,4,1,1,1,3,1,
1,6,4,21,1,1,1,0,4,1,1,
1,3,4,8,1,1,1,21,8,0,0,
0,0,0,0,0,0,0,0,0,0,0,
0,0,0,0,0,0,0,0,0,0,0,
0,0,0,0,0,0,0,0,0,0,0,
0,0,0,0,0,0,0,0,0,0,0.
[layer]
type=Tile Layer 2
data=
105,52,52,105,105,105,0,0,0,0,0,
0,69,69,69,69,69,0,0,0,0,0,
0,68,68,68,68,68,0,0,0,0,0,
43,43,43,0,43,43,43,43,21,21,43,
0,61,61,61,61,61,0,0,0,0,0,
0,120,120,120,120,120,0,0,0,0,0,
53,53,0,53,53,53,0,0,0,0,0,
0,52,0,52,52,52,0,0,0,0,0,
0,38,0,76,76,76,0,0,0,0,0,
50,50,50,50,0,0,0,0,0,0,0,
0,0,0,0,49,49,49,49,49,49,49,
38,38,38,0,38,38,38,0,38,38,38,
94,94,94,0,94,94,94,0,0,0,0,
0,0,0,0,0,0,0,0,0,0,0,
0,0,0,0,0,0,0,0,0,0,0,
0,0,0,0,0,0,0,0,0,0,0,
0,0,0,0,0,0,0,0,0,0,0.