[layer]
type=Tile Layer 1
data=
1,21,1,1,0,0,1,0,1,1,0,
0,1,1,1,1,0,0,7,21,0,0,
0,1,2,1,0,0,1,0,0,2,21,
0,1,1,1,1,1,1,1,1,1,1,
1,0,0,0,1,1,1,0,21,0,1,
0,0,0,0,0,1,1,1,1,0,1,
1,0,0,0,0,1,1,0,21,1,0,
1,1,1,0,0,0,21,1,1,1,1,
0,2,2,1,0,0,0,21,1,1,1,
2,1,1,21,2,0,0,0,7,1,0,
1,1,1,0,1,0,24,1,1,1,21,
0,0,0,0,0,1,1,1,1,21,0,
0,0,0,0,1,1,1,1,21,0,1,
0,0,0,0,0,0,0,0,0,0,0,
0,0,0,0,0,0,0,0,0,0,0,
0,0,0,0,0,0,0,0,0,0,0,
0,0,0,0,0,0,0,0,0,0,0.
[layer]
type=Tile Layer 2
data=
69,0,69,69,0,0,69,0,69,69,0,
0,102,102,102,102,0,0,0,0,0,0,
0,66,66,66,0,0,66,0,0,66,0,
0,42,42,42,42,42,42,42,42,42,42,
60,0,0,0,60,60,60,0,0,0,60,
0,0,0,0,0,59,59,59,59,0,59,
53,0,0,0,0,53,53,0,0,53,0,
52,52,52,0,0,0,0,52,52,52,52,
0,51,51,51,0,0,0,0,51,51,51,
75,75,75,0,75,0,0,0,0,75,0,
73,73,73,0,73,0,0,73,73,73,0,
0,0,0,0,0,48,48,48,48,0,0,
0,0,0,0,47,47,47,47,0,0,47,
0,0,0,0,0,0,0,0,0,0,0,
0,0,0,0,0,0,0,0,0,0,0,
0,0,0,0,0,0,0,0,0,0,0,
0,0,0,0,0,0,0,0,0,0,0.