[layer]
type=Tile Layer 1
data=
0,1,0,0,0,1,0,0,0,6,0,
2,1,1,6,0,1,3,1,0,2,1,
0,21,0,0,0,8,4,1,0,1,0,
1,1,6,1,0,1,1,1,21,3,0,
0,3,1,0,0,1,21,0,0,1,0,
0,5,1,1,1,1,21,5,4,1,1,
0,0,0,1,0,0,21,4,0,0,0,
1,1,0,6,21,1,1,3,0,1,1,
0,1,0,0,0,5,0,0,0,1,21,
1,0,2,1,1,1,3,1,4,4,1,
0,0,21,1,0,0,0,3,0,0,0,
5,2,8,1,0,5,2,1,21,1,1,
21,1,0,0,0,1,2,1,0,0,0,
8,6,5,6,1,2,21,1,2,1,1,
1,2,2,6,1,5,1,1,1,0,1,
6,1,0,5,0,1,1,1,21,1,0,
0,1,0,5,0,1,1,5,0,21,0,
21,1,0,1,0,3,0,5,1,1,1,
0,1,4,1,0,1,0,0,0,0,21,
0,0,0,0,0,0,0,0,0,0,0,
0,0,0,0,0,0,0,0,0,0,0,
0,0,0,0,0,0,0,0,0,0,0,
0,0,0,0,0,0,0,0,0,0,0.
[layer]
type=Tile Layer 2
data=
0,86,0,0,0,86,0,0,0,86,0,
77,77,77,77,0,77,77,77,0,77,77,
0,0,0,0,0,0,129,129,0,129,0,
92,92,92,92,0,92,92,92,0,92,0,
0,91,91,0,0,91,0,0,0,91,0,
0,80,80,80,80,80,0,80,80,80,80,
0,0,0,82,0,0,0,82,0,0,0,
81,81,0,81,0,81,81,81,0,81,81,
0,79,0,0,0,79,0,0,0,79,0,
58,0,58,58,58,58,58,58,58,58,58,
0,0,0,72,0,0,0,72,0,0,0,
106,106,0,106,0,106,106,106,0,106,106,
0,63,0,0,0,63,63,63,0,0,0,
0,84,84,84,84,84,0,84,84,84,84,
49,49,49,49,49,49,49,49,49,0,49,
61,61,0,61,0,61,61,61,0,61,0,
0,60,0,60,0,60,60,60,0,0,0,
0,59,0,59,0,59,0,59,59,59,59,
0,58,58,58,0,58,0,0,0,0,0,
0,0,0,0,0,0,0,0,0,0,0,
0,0,0,0,0,0,0,0,0,0,0,
0,0,0,0,0,0,0,0,0,0,0,
0,0,0,0,0,0,0,0,0,0,0.