[layer]
type=Tile Layer 1
data=
1,4,1,3,21,6,8,1,1,1,1,
0,0,0,0,0,5,21,1,1,1,0,
0,0,0,0,0,6,0,1,1,1,21,
0,0,0,0,0,17,0,1,0,3,1,
0,0,0,0,21,6,0,1,0,1,1,
17,1,17,1,17,5,0,1,21,5,1,
8,0,0,21,0,1,5,1,0,4,1,
5,1,1,0,1,1,1,1,1,3,1,
1,1,5,1,1,1,1,6,21,3,0,
0,0,0,0,0,0,0,0,0,0,0,
0,0,0,0,0,0,0,0,0,0,0,
0,0,0,0,0,0,0,0,0,0,0,
0,0,0,0,0,0,0,0,0,0,0.
[layer]
type=Tile Layer 2
data=
55,55,55,55,0,55,0,55,55,55,55,
0,0,0,0,0,45,0,45,45,45,0,
0,0,0,0,0,40,0,40,40,40,0,
0,0,0,0,0,19,0,39,0,39,39,
0,0,0,0,0,39,0,39,0,39,39,
15,30,15,30,15,30,0,30,0,30,30,
0,0,0,0,0,55,55,55,0,55,55,
26,26,26,0,26,26,26,26,26,26,26,
29,29,29,29,29,29,29,29,0,29,0,
0,0,0,0,0,0,0,0,0,0,0,
0,0,0,0,0,0,0,0,0,0,0,
0,0,0,0,0,0,0,0,0,0,0,
0,0,0,0,0,0,0,0,0,0,0.