[layer]
type=Tile Layer 1
data=
0,1,0,0,0,0,0,0,0,6,0,
0,1,0,0,3,0,1,0,0,1,0,
0,1,3,24,4,0,1,0,4,6,0,
0,1,5,4,1,4,1,1,1,1,0,
0,21,1,16,5,4,1,5,1,21,0,
0,0,21,1,1,4,1,3,21,0,0,
0,0,21,1,1,1,5,5,21,0,0,
0,0,0,21,1,6,6,21,0,0,0,
0,0,21,6,0,16,0,6,21,0,0,
0,0,0,0,0,0,0,0,0,0,0,
0,0,0,0,0,0,0,0,0,0,0,
0,0,0,0,0,0,0,0,0,0,0,
0,0,0,0,0,0,0,0,0,0,0.
[layer]
type=Tile Layer 2
data=
0,58,0,0,0,0,0,0,0,58,0,
0,58,0,0,58,0,58,0,0,58,0,
0,78,78,0,78,0,78,0,78,78,0,
0,41,41,41,41,41,41,41,41,41,0,
0,0,52,26,52,52,52,52,52,0,0,
0,0,0,50,50,50,50,50,0,0,0,
0,0,0,48,48,48,48,48,0,0,0,
0,0,0,0,46,46,46,0,0,0,0,
0,0,0,45,0,22,0,45,0,0,0,
0,0,0,0,0,0,0,0,0,0,0,
0,0,0,0,0,0,0,0,0,0,0,
0,0,0,0,0,0,0,0,0,0,0,
0,0,0,0,0,0,0,0,0,0,0.