[layer]
type=Tile Layer 1
data=
0,1,2,2,22,0,0,0,0,0,0,
2,2,1,1,2,21,0,0,0,0,0,
1,1,1,1,1,22,8,24,0,0,0,
1,1,1,1,0,0,0,0,0,0,0,
1,1,1,1,1,8,0,22,21,0,0,
8,1,1,1,1,1,0,1,1,21,0,
0,7,1,1,2,2,1,1,1,1,21,
7,0,0,1,1,1,1,1,1,1,1,
0,0,0,7,1,1,1,1,1,1,0,
0,0,0,0,0,0,0,0,0,0,0,
0,0,0,0,0,0,0,0,0,0,0,
0,0,0,0,0,0,0,0,0,0,0,
0,0,0,0,0,0,0,0,0,0,0.
[layer]
type=Tile Layer 2
data=
0,72,72,72,0,0,0,0,0,0,0,
71,71,71,71,71,0,0,0,0,0,0,
126,126,126,126,126,0,0,0,0,0,0,
62,62,62,62,0,0,0,0,0,0,0,
93,93,93,93,93,0,0,0,0,0,0,
0,90,90,90,90,90,0,90,90,0,0,
0,0,88,88,88,88,88,88,88,88,0,
0,0,0,88,88,88,88,88,88,88,88,
0,0,0,0,88,88,88,88,88,88,0,
0,0,0,0,0,0,0,0,0,0,0,
0,0,0,0,0,0,0,0,0,0,0,
0,0,0,0,0,0,0,0,0,0,0,
0,0,0,0,0,0,0,0,0,0,0.