[layer]
type=Tile Layer 1
data=
0,16,3,0,0,0,24,0,1,1,0,
0,6,0,0,1,1,17,0,0,1,0,
0,0,0,4,21,21,21,5,0,0,0,
0,0,4,21,1,6,1,21,1,0,0,
0,0,1,21,1,1,6,21,3,0,0,
0,0,1,21,3,1,6,21,1,0,0,
0,1,0,21,5,1,6,21,0,1,0,
0,5,0,4,17,1,1,1,0,1,0,
0,1,0,6,1,1,3,1,0,1,0,
0,0,0,0,0,0,0,0,0,0,0,
0,0,0,0,0,0,0,0,0,0,0,
0,0,0,0,0,0,0,0,0,0,0,
0,0,0,0,0,0,0,0,0,0,0.
[layer]
type=Tile Layer 2
data=
0,57,114,0,0,0,0,0,114,114,0,
0,76,0,0,76,76,38,0,0,76,0,
0,0,0,68,0,0,0,68,0,0,0,
0,0,66,0,66,66,66,0,66,0,0,
0,0,64,0,64,64,64,0,64,0,0,
0,0,62,0,62,62,62,0,62,0,0,
0,60,0,0,60,60,60,0,0,60,0,
0,59,0,59,29,59,59,59,0,59,0,
0,59,0,59,59,59,59,59,0,59,0,
0,0,0,0,0,0,0,0,0,0,0,
0,0,0,0,0,0,0,0,0,0,0,
0,0,0,0,0,0,0,0,0,0,0,
0,0,0,0,0,0,0,0,0,0,0.