[layer]
type=Tile Layer 1
data=
0,0,0,0,0,1,0,1,4,1,0,
0,0,0,0,1,5,0,1,1,3,1,
0,0,0,3,1,1,0,1,4,1,1,
0,0,0,1,21,1,1,0,3,3,1,
0,0,0,21,6,21,6,1,0,0,0,
0,0,0,3,21,1,21,1,3,1,1,
0,1,6,21,1,21,5,21,4,1,0,
0,1,1,6,21,3,21,1,1,0,0,
0,0,1,4,1,0,0,0,0,0,0,
0,0,0,0,0,0,0,0,0,0,0,
0,0,0,0,0,0,0,0,0,0,0,
0,0,0,0,0,0,0,0,0,0,0,
0,0,0,0,0,0,0,0,0,0,0.
[layer]
type=Tile Layer 2
data=
0,0,0,0,0,74,0,74,74,74,0,
0,0,0,0,74,74,0,74,74,74,74,
0,0,0,67,67,67,0,67,67,67,67,
0,0,0,67,0,67,67,0,67,67,67,
0,0,0,0,66,0,66,66,0,0,0,
0,0,0,64,0,64,0,64,64,64,64,
0,62,62,0,62,0,62,0,62,62,0,
0,59,59,59,0,59,0,59,59,0,0,
0,0,58,58,58,0,0,0,0,0,0,
0,0,0,0,0,0,0,0,0,0,0,
0,0,0,0,0,0,0,0,0,0,0,
0,0,0,0,0,0,0,0,0,0,0,
0,0,0,0,0,0,0,0,0,0,0.