[layer]
type=Tile Layer 1
data=
0,4,1,1,0,0,0,1,6,1,0,
1,4,1,6,1,23,1,5,1,1,1,
0,1,1,4,0,0,0,1,4,1,0,
0,0,6,21,1,5,1,21,1,0,0,
0,0,1,0,0,0,0,0,5,0,0,
0,5,1,1,0,0,0,1,6,1,0,
1,1,3,1,1,23,3,1,1,5,1,
0,1,1,4,0,0,0,3,1,1,0,
0,0,6,0,0,0,0,0,1,0,0,
0,0,0,0,0,0,0,0,0,0,0,
0,0,0,0,0,0,0,0,0,0,0,
0,0,0,0,0,0,0,0,0,0,0,
0,0,0,0,0,0,0,0,0,0,0.
[layer]
type=Tile Layer 2
data=
0,81,81,81,0,0,0,81,81,81,0,
73,73,73,73,73,0,73,73,73,73,73,
0,72,72,72,0,0,0,72,72,72,0,
0,0,72,0,72,72,72,0,72,0,0,
0,0,70,0,0,0,0,0,70,0,0,
0,70,70,70,0,0,0,70,70,70,0,
63,63,63,63,63,0,63,63,63,63,63,
0,70,70,70,0,0,0,70,70,70,0,
0,0,70,0,0,0,0,0,70,0,0,
0,0,0,0,0,0,0,0,0,0,0,
0,0,0,0,0,0,0,0,0,0,0,
0,0,0,0,0,0,0,0,0,0,0,
0,0,0,0,0,0,0,0,0,0,0.