[layer]
type=Tile Layer 1
data=
0,1,0,1,21,0,0,16,0,16,0,
0,1,0,1,1,1,1,17,0,21,0,
0,1,0,0,1,1,1,1,0,1,0,
0,1,0,21,1,1,1,0,0,0,0,
0,1,0,0,1,1,1,21,0,1,0,
0,21,20,24,1,1,1,0,20,0,0,
0,1,20,1,1,1,1,0,20,21,0,
20,1,20,0,7,21,1,0,20,0,20,
20,1,1,1,1,0,1,0,21,0,20,
20,7,1,1,1,1,1,0,0,21,20,
20,21,1,1,1,8,1,0,0,7,20,
0,0,0,0,0,0,0,0,0,0,0,
0,0,0,0,0,0,0,0,0,0,0,
0,0,0,0,0,0,0,0,0,0,0,
0,0,0,0,0,0,0,0,0,0,0.
[layer]
type=Tile Layer 2
data=
0,60,0,60,0,0,0,30,0,30,0,
0,54,0,54,54,54,54,27,0,0,0,
0,53,0,0,53,53,53,53,0,53,0,
0,53,0,0,53,53,53,0,0,0,0,
0,46,0,0,46,46,46,0,0,46,0,
0,0,0,0,69,69,69,0,0,0,0,
0,45,0,45,45,45,45,0,0,0,0,
0,66,0,0,0,0,66,0,0,0,0,
0,43,43,43,43,0,43,0,0,0,0,
0,0,63,63,63,63,63,0,0,0,0,
0,0,82,82,82,0,82,0,0,0,0,
0,0,0,0,0,0,0,0,0,0,0,
0,0,0,0,0,0,0,0,0,0,0,
0,0,0,0,0,0,0,0,0,0,0,
0,0,0,0,0,0,0,0,0,0,0.