[layer]
type=Tile Layer 1
data=
0,0,4,0,1,8,1,21,1,0,0,
1,1,3,1,5,1,1,21,1,0,0,
21,0,5,0,1,0,1,3,1,1,1,
0,21,1,0,3,0,1,0,1,0,0,
5,1,1,6,1,0,1,21,1,0,0,
0,21,1,0,3,8,1,3,1,1,1,
21,0,5,8,1,0,1,0,1,0,0,
1,1,1,1,1,3,6,0,1,0,21,
0,21,5,0,6,0,1,1,1,1,1,
0,21,1,0,1,0,4,0,1,0,0,
4,1,1,1,1,0,1,0,5,0,21,
0,21,1,0,6,0,1,5,1,1,1,
0,0,1,21,3,0,0,0,0,0,0,
0,21,0,0,0,0,0,0,0,0,0,
0,0,0,0,0,0,0,0,0,0,0,
0,0,0,0,0,0,0,0,0,0,0,
0,0,0,0,0,0,0,0,0,0,0.
[layer]
type=Tile Layer 2
data=
0,0,108,0,108,0,108,0,108,0,0,
63,63,63,63,63,63,63,0,63,0,0,
0,0,70,0,70,0,70,70,70,70,70,
0,0,63,0,63,0,63,0,63,0,0,
62,62,62,62,62,0,62,0,62,0,0,
0,0,91,0,91,0,91,91,91,91,91,
0,0,81,0,81,0,81,0,81,0,0,
47,47,47,47,47,47,47,0,47,0,0,
0,0,52,0,52,0,52,52,52,52,52,
0,0,51,0,51,0,51,0,51,0,0,
50,50,50,50,50,0,50,0,50,0,0,
0,0,49,0,49,0,49,49,49,49,49,
0,0,48,0,48,0,0,0,0,0,0,
0,0,0,0,0,0,0,0,0,0,0,
0,0,0,0,0,0,0,0,0,0,0,
0,0,0,0,0,0,0,0,0,0,0,
0,0,0,0,0,0,0,0,0,0,0.