[layer]
type=Tile Layer 1
data=
1,4,21,1,3,1,1,1,0,5,1,
5,1,1,0,1,1,1,3,4,1,1,
1,1,6,4,0,1,1,1,1,6,0,
0,0,0,6,0,0,0,0,1,1,21,
2,1,24,2,6,1,21,5,1,3,1,
0,2,0,0,0,0,0,5,0,21,0,
0,1,4,6,1,1,1,3,21,1,1,
0,1,21,0,0,4,0,0,0,1,0,
4,1,0,1,0,1,21,1,1,3,0,
0,0,21,2,0,1,0,0,0,0,0,
0,1,1,1,21,1,1,5,5,4,1,
0,5,21,0,0,1,0,0,0,0,0,
1,1,1,1,4,1,1,4,3,1,0,
0,1,0,1,4,4,0,0,0,1,0,
0,1,21,1,1,1,1,6,0,5,1,
0,0,0,0,0,0,0,0,0,0,0,
0,0,0,0,0,0,0,0,0,0,0,
0,0,0,0,0,0,0,0,0,0,0,
0,0,0,0,0,0,0,0,0,0,0.
[layer]
type=Tile Layer 2
data=
60,60,0,60,60,60,60,60,0,60,60,
53,53,53,0,53,53,53,53,53,53,53,
55,55,55,55,0,55,55,55,55,55,0,
0,0,0,69,0,0,0,0,69,69,0,
81,81,0,81,81,81,0,81,81,81,81,
0,61,0,0,0,0,0,61,0,0,0,
0,48,48,48,48,48,48,48,0,48,48,
0,59,0,0,0,59,0,0,0,59,0,
52,52,0,52,0,52,0,52,52,52,0,
0,0,0,51,0,51,0,0,0,0,0,
0,40,40,40,0,40,40,40,40,40,40,
0,49,0,0,0,49,0,0,0,0,0,
34,34,34,34,34,34,34,34,34,34,0,
0,48,0,48,48,48,0,0,0,48,0,
0,43,0,43,43,43,43,43,0,43,43,
0,0,0,0,0,0,0,0,0,0,0,
0,0,0,0,0,0,0,0,0,0,0,
0,0,0,0,0,0,0,0,0,0,0,
0,0,0,0,0,0,0,0,0,0,0.