[layer]
type=Tile Layer 1
data=
0,21,1,0,21,1,0,21,1,0,0,
21,1,0,21,17,0,21,1,0,8,0,
0,21,1,0,21,1,0,21,1,0,0,
0,0,0,0,0,0,0,0,0,0,0,
8,0,0,1,1,1,16,1,0,0,0,
0,0,1,0,0,1,1,1,1,0,0,
0,1,0,0,1,1,1,1,1,1,0,
0,1,0,1,1,1,1,0,1,1,0,
0,1,1,1,1,1,1,1,1,1,0,
0,0,0,0,0,0,0,0,0,0,0,
0,0,0,0,0,0,0,0,0,0,0,
0,0,0,0,0,0,0,0,0,0,0,
0,0,0,0,0,0,0,0,0,0,0.
[layer]
type=Tile Layer 2
data=
0,0,61,0,0,61,0,0,61,0,0,
0,87,0,0,43,0,0,87,0,0,0,
0,0,49,0,0,49,0,0,49,0,0,
0,0,0,0,0,0,0,0,0,0,0,
0,0,0,70,70,70,35,70,0,0,0,
0,0,47,0,0,47,47,47,47,0,0,
0,47,0,0,47,47,47,47,47,47,0,
0,47,0,47,47,47,47,0,47,47,0,
0,38,38,38,38,38,38,38,38,38,0,
0,0,0,0,0,0,0,0,0,0,0,
0,0,0,0,0,0,0,0,0,0,0,
0,0,0,0,0,0,0,0,0,0,0,
0,0,0,0,0,0,0,0,0,0,0.