[layer]
type=Tile Layer 1
data=
0,0,0,0,0,21,1,5,1,5,1,
0,0,0,0,21,6,1,1,1,6,1,
0,0,0,21,6,4,1,1,1,1,1,
0,1,0,0,0,1,1,1,6,5,21,
5,6,1,0,0,1,1,1,1,6,21,
0,1,0,0,0,1,4,1,1,5,1,
0,0,0,0,0,0,4,5,21,21,1,
0,0,0,0,0,21,0,4,1,5,1,
0,0,0,0,21,1,3,1,1,3,1,
0,0,0,0,0,0,0,0,0,0,0,
0,0,0,0,0,0,0,0,0,0,0,
0,0,0,0,0,0,0,0,0,0,0,
0,0,0,0,0,0,0,0,0,0,0.
[layer]
type=Tile Layer 2
data=
0,0,0,0,0,0,84,84,84,84,84,
0,0,0,0,0,83,83,83,83,83,83,
0,0,0,0,74,74,74,74,74,74,74,
0,73,0,0,0,73,73,73,73,73,0,
72,72,72,0,0,72,72,72,72,72,0,
0,71,0,0,0,71,71,71,71,71,71,
0,0,0,0,0,0,71,71,0,0,71,
0,0,0,0,0,0,0,69,69,69,69,
0,0,0,0,0,68,68,68,68,68,68,
0,0,0,0,0,0,0,0,0,0,0,
0,0,0,0,0,0,0,0,0,0,0,
0,0,0,0,0,0,0,0,0,0,0,
0,0,0,0,0,0,0,0,0,0,0.