[layer]
type=Tile Layer 1
data=
0,0,1,0,21,0,0,0,1,1,1,
0,17,1,1,8,21,0,17,1,1,1,
1,1,1,1,1,0,21,0,1,0,1,
0,17,17,1,0,0,0,21,1,1,1,
0,1,1,1,0,0,0,0,21,0,0,
0,0,0,0,0,0,0,21,1,0,0,
0,1,0,0,0,0,21,1,1,1,0,
1,1,1,0,0,21,1,1,1,1,1,
1,16,1,1,21,0,0,1,1,16,0,
0,0,0,0,0,0,0,0,0,0,0,
0,0,0,0,0,0,0,0,0,0,0,
0,0,0,0,0,0,0,0,0,0,0,
0,0,0,0,0,0,0,0,0,0,0.
[layer]
type=Tile Layer 2
data=
0,0,74,0,0,0,0,0,74,74,74,
0,54,109,109,0,0,0,54,109,109,109,
65,65,65,65,65,0,0,0,65,0,65,
0,32,32,64,0,0,0,0,64,64,64,
0,63,63,63,0,0,0,0,0,0,0,
0,0,0,0,0,0,0,0,62,0,0,
0,61,0,0,0,0,0,61,61,61,0,
60,60,60,0,0,0,60,60,60,60,60,
59,29,59,59,0,0,0,59,59,29,0,
0,0,0,0,0,0,0,0,0,0,0,
0,0,0,0,0,0,0,0,0,0,0,
0,0,0,0,0,0,0,0,0,0,0,
0,0,0,0,0,0,0,0,0,0,0.