[layer]
type=Tile Layer 1
data=
0,21,21,21,21,21,21,21,21,21,0,
6,4,1,1,1,1,1,1,1,3,5,
1,1,1,1,1,1,1,1,1,1,0,
0,1,1,1,21,21,21,21,21,21,4,
1,1,1,1,21,5,1,1,1,1,1,
8,1,1,1,21,21,21,21,21,21,21,
1,1,1,1,1,1,1,1,1,1,1,
0,0,0,0,0,0,0,0,0,0,0,
0,0,0,0,0,0,0,0,0,0,0,
0,0,0,0,0,0,0,0,0,0,0,
0,0,0,0,0,0,0,0,0,0,0,
0,0,0,0,0,0,0,0,0,0,0.
[layer]
type=Tile Layer 2
data=
0,0,0,0,0,0,0,0,0,0,0,
20,20,20,20,20,20,20,20,20,20,20,
5,20,20,20,20,20,20,20,20,20,0,
0,2,5,20,0,0,0,0,0,0,20,
2,2,5,20,0,20,20,20,20,20,20,
0,2,5,20,0,0,0,0,0,0,0,
2,2,5,30,30,30,30,30,30,30,30,
0,0,0,0,0,0,0,0,0,0,0,
0,0,0,0,0,0,0,0,0,0,0,
0,0,0,0,0,0,0,0,0,0,0,
0,0,0,0,0,0,0,0,0,0,0,
0,0,0,0,0,0,0,0,0,0,0.
