[layer]
type=Tile Layer 1
data=
21,21,1,0,1,0,1,1,1,6,4,
21,21,1,0,1,3,5,6,6,4,1,
21,21,1,0,1,1,3,0,3,5,1,
21,21,1,0,1,1,1,0,1,3,5,
21,21,1,0,1,0,0,4,1,6,4,
21,21,1,0,1,1,1,1,6,4,1,
0,0,0,0,0,0,0,0,0,0,0,
0,0,0,0,0,0,0,0,0,0,0,
0,0,0,0,0,0,0,0,0,0,0,
0,0,0,0,0,0,0,0,0,0,0,
0,0,0,0,0,0,0,0,0,0,0.
[layer]
type=Tile Layer 2
data=
0,0,2,0,30,0,10,10,10,10,10,
0,0,2,0,30,25,10,10,10,10,10,
0,0,2,0,30,25,25,0,10,10,10,
0,0,2,0,30,25,25,0,10,10,10,
0,0,2,0,30,0,0,10,10,10,10,
0,0,2,0,30,30,30,30,10,10,10,
0,0,0,0,0,0,0,0,0,0,0,
0,0,0,0,0,0,0,0,0,0,0,
0,0,0,0,0,0,0,0,0,0,0,
0,0,0,0,0,0,0,0,0,0,0,
0,0,0,0,0,0,0,0,0,0,0.
